1943	1943	1943 - The Battle of Midway (Go!/Probe)
1000ccTurbo	1000ccTurbo	1000cc Turbo (Energize)
1000Miglia	1000Miglia	1000 Miglia (Simulmondo)
3001OConnersFight2	3001OConnersFight2	3001 O'Conners Fight 2 ()
3DGalax	3DGalax	3D Galax (Gremlin)
3DPool	3DPool	3D Pool (Aardvark Software/Firebird)
4DSportsBoxing	4DSportsBoxing	4D Sports Boxing (Mindscape)
4DSportsDriving	4DSportsDriving	4D Sports Driving (Mindscape)
4x4OffRoadRacing	4x4OffRoadRacing	4x4 Off Road Racing (Epyx/U.S.Gold)
5thGear	5thGear	5th Gear (Hewson)
688AttackSub	688AttackSub	688 Attack Sub (Electronic Arts)
7Colors	7Colors	7 Colors (Infogrames)
944TurboCup	944TurboCup	944 Turbo Cup (Loriciel)
9Lives	9Lives	9 Lives (ARC)
A10TankKiller	A10TankKiller	A10 Tank Killer (Dynamix)
AbandonedPlaces	AbandonedPlaces	Abandoned Places (ArtGame)
AbandonedPlaces2	AbandonedPlaces2	Abandoned Places 2 (ICE)
AbraCadabra	AbraCadabra	Abra Cadabra / Baba Yaga (Coktel Vision)
Academy	Academy	Academy (CRL Group/ComTek)
ACSysDemo	ACSysDemo	A.C.SYS (Joerg Belger)
ActionFighter	ActionFighter	Action Fighter (Sega)
AddamsFamily	AddamsFamily	The Addams Family (Ocean/Paramount Pictures)
Adrenalynn	Adrenalynn	Adrenalynn (Exponentia)
AdvancedSkiSimulator	AdvancedSkiSimulator	Advanced Ski Simulator (Code Masters)
AdvantageTennis	AdvantageTennis	Advantage Tennis (Infogrames)
AdventureConstructionSet	AdventureConstructionSet	Adventure Construction Set (Electronic Arts)
AdventuresOfQuik&Silva	QuikAndSilva	"Quik &amp; Silva (New Bits on the Ram)"
AdventuresOfRobinHood	AdventuresOfRobinHood	Adventures of Robin Hood (Millennium)
AdventuresOfWillyBeamish	WillyBeamish	The Adventures Of Willy Beamish (Dynamix)
AfterBurner88	AfterBurner88	After Burner '88 (Argonaut Software)
AfterBurner89	AfterBurner89	After Burner '89 (WeeBee Games/Sega)
AfterTheWar	AfterTheWar	After the War (Dinamic)
Age	Age	AGE (Coktel Vision/Empire)
Agony	Agony	Agony (Psygnosis)
AgonyDemo	AgonyDemo	Agony Demo (Psygnosis)
Airball	Airball	Airball (Microdeal)
AirborneRanger	AirborneRanger	Airborne Ranger (Microprose)
AirSupport	AirSupport	Air Support (Psygnosis)
Akira	Akira	Akira (ICE)
Aladdin	Aladdin	Aladdin (Virgin)
Alcatraz	Alcatraz	Alcatraz (Infogrames)
AlchemyDemo	AlchemyDemo	Alchemy Demo (Psygnosis)
AlfredChicken	AlfredChicken	Alfred Chicken (Twilight/Mindscape)
Alianator	Alianator	Alianator (P.S.)
Alien3	Alien3	Alien III (20th Century Fox)
AlienBash2	AlienBash2	Alien Bash 2 (Glen Cumming/Myles Jeffery)
AlienBreed	AlienBreed	Alien Breed (Team 17)
AlienBreed2	AlienBreed2	Alien Breed 2 (Team 17)
AlienBreed3D	AlienBreed3D	Alien Breed 3D (Team 17)
AlienBreed3D2	AlienBreed3D2	Alien Breed 3D II: The Killing Grounds (Team 17)
AlienBreedSpecialEdition	AlienBreedSE92	Alien Breed Special Edition '92 (Team 17)
AlienBreedStory	AlienBreedStory	Alien Breed Story (Team 17)
AlienBreedTowerAssault	AlienBreedTA	Alien Breed Tower Assault (Team 17)
AlienFishFinger	AlienFishFinger	Alien Fish Finger (Skull Army/Davis J. Cruickshank)
AlienLegion	AlienLegion	Alien Legion (Pegasus)
AlienStorm	AlienStorm	Alien Storm (Sega/U.S.Gold)
AlienSyndrome	AlienSyndrome	Alien Syndrome (SEGA)
AlienWorld	AlienWorld	Alien World (PAL Developments/Hi-Tec)
Aliex	Aliex	Aliex (Trojan)
AllanBordersCricket	AllanBordersCricket	Allan Border's Cricket (Audiogenic)
AllNewWorldOfLemmings	Lemmings3	Lemmings 3 (DMA Design/Psygnosis)
AlloAllo	AlloAllo	Allo 'Allo (Alternative)
AllTerrainRacing	AllTerrainRacing	All Terrain Racing (Team 17)
AllTerrainRacingXmasDemo	AllTerrainRacingXmas	All Terrain Racing Xmas (Team 17)
Alpha1	Alpha1	Alpha-1 (ECP)
AlphaWaves	AlphaWaves	Alpha Waves (Infogrames)
AlteredBeast	AlteredBeast	Altered Beast (Sega/Activision)
AlteredDestiny	AlteredDestiny	Altered Destiny (Accolade)
AmazingSpiderman	AmazingSpiderman	Amazing SpiderMan (Paragon/Oxford Digital/Empire)
Amberstar	Amberstar	Amberstar (Thalion)
Amegas	Amegas	Amegas (Guido Bartels/reLINE)
AmericanGladiators	AmericanGladiators	American Gladiators (GameTek/Imagitec Design)
AmericanTagTeamWrestling	AmericanTagTeamWrestling	American Tag Team Wrestling (Zeppelin)
AmigaKarate	AmigaKarate	Amiga Karate (Paradox/Eidersoft)
Amnios	Amnios	Amnios (Psygnosis)
Anarchy	Anarchy	Anarchy (Psygnosis)
AnotherWorld	AnotherWorld	Another World / Out of this World (Delphine Software)
Anstoss	Anstoss	Anstoss / Carton Rouge (Ascon)
Antago	Antago	Antago (Art of Dreams)
Apache	ApacheOverdrive	Apache / Overdrive (Team 17)
ApacheFlight	ApacheFlight	Apache Flight (Atlantis)
ApanoSin	ApanoSin	Apano Sin (Level One)
APB	APB	APB (Tengen)
Apidya	Apidya	Apidya (Kaiko)
Apocalypse	Apocalypse	Apocalypse (Miracle Games/Virgin)
Apprentice	Apprentice	Apprentice (Rainbow Arts)
Aquablast	Aquablast	Aquablast (Elite)
Aquanaut	Aquanaut	Aquanaut (F1 Licenceware)
AquaticGames	AquaticGames	Aquatic Games (Millennium)
Aquaventura	Aquaventura	Aquaventura (Psygnosis)
ArabianNights	ArabianNights	Arabian Nights (Krisalis)
ArcadeFruitMachine	ArcadeFruitMachine	Arcade Fruit Machine (Zeppelin Games)
ArcadePool	ArcadePool	Arcade Pool (Team 17)
ArcadeSnooker	ArcadeSnooker	Arcade Snooker (Team 17)
ArcadeTriviaQuiz	ArcadeTriviaQuiz	Arcade Trivia Quiz (Zeppelin Games)
ArcherMacleansBillardAmericain	ArcherMacleansBillardAmericain	Archer Maclean Pool / Archer Maclean Billard Americain (Virgin)
ArcherMacleansPool	ArcherMacleanPool	Archer Maclean Pool / Archer Maclean Billard Americain (Virgin)
Archipelagos	Archipelagos	Archipelagos (Astral Software)
Archon	Archon	Archon (Electronic Arts)
Archon2	Archon2	Archon 2: Adept (Electronic Arts)
ArcticFox	ArcticFox	Arctic Fox (Electronic Arts)
Arena	Arena	Arena (Psygnosis)
Arkanoid	Arkanoid	Arkanoid (Discovery Software)
ArkanoidRevengeOfDoh	Arkanoid2	Arkanoid - Revenge of Doh (Imagine)
ArmageddonMan	ArmageddonMan	Armageddon Man (Electronic Pencil/Martech)
Armalyte	Armalyte	Armalyte (Thalamus)
ArmourGeddon	ArmourGeddon	Armour Geddon (Psygnosis)
ArmourGeddon2	ArmourGeddon2	Armour Geddon 2 (Psygnosis)
ArmyMoves	ArmyMoves	Army Moves (Imagine/Dinamic)
Arnie	Arnie	Arnie (Zeppelin Games/Realms of Fantasy)
Arnie2	Arnie2	Arnie 2 (Zeppelin)
Artura	Artura	Artura (Gremlin/Arcadia)
AshesOfEmpire	AshesOfEmpire	Ashes Of Empire (Midnight)
Assassin	Assassin	Assassin (Team 17)
AssassinSpecialEdition	AssassinSE	Assassin Special Edition (Team 17)
Astaroth	Astaroth	Astaroth (Hewson)
Astatin	Astatin	Astatin (Tale Software/Alive Designs)
AsterixGetafix	AsterixGetafix	Asterix - Operation Getafix (Coktel Vision)
AstroMarineCorps	AstroMarineCorps	Astro Marine Corps (Dinamic)
Atax	Atax	Atax (Axxiom)
ATF2	ATF2	Advanced Tactical Fighter II (Digital Integration)
AtomicRoboKid	AtomicRoboKid	Atomic Robo-Kid (Activision)
Atomino	Atomino	Atomino (Play Byte/Psygnosis)
Atomix	Atomix	Atomix (Thalion)
ATrain	ATrain	A-Train (Maxis)
AufschwungOst	AufschwungOst	Aufschwung Ost (Sunflowers)
AuntArcticAdventure	AuntArcticAdventure	Aunt Arctic Adventure (Midware)
AustraloPiticusMechanicus	AustraloPiticusMechanicus	Australo Piticus Mechanicus (Hack+Slay Team)
AventuresDeMoktar	Moktar	Moktar / Titus the Fox (Titus)
Awesome	Awesome	Awesome (Psygnosis)
AwesomeDemo	AwesomeDemo	Awesome Demo (Psygnosis)
AxelsMagicHammer	AxelsMagicHammer	Axel's Magic Hammer (Core Design/Gremlin)
AxeOfRage	AxeOfRage	Barbarian 2 / Axe of Rage (Palace)
AztecChallenge	AztecChallenge	Aztec Challenge (Bignonia)
B17FlyingFortress	B17FlyingFortress	B17 Flying Fortress (MicroProse)
BabyJoInGoingHome	BabyJoInGoingHome	Baby Jo In Going Home (Loriciel)
Backlash	Backlash	Backlash (Novagen)
BackToTheFuturePart2	BackToTheFuture2	Back To The Future 2 (Imageworks/Images)
BackToTheFuturePart3	BackToTheFuture3	Back To The Future 3 (Imageworks/Konami)
BadCompany	BadCompany	Bad Company (Logotron)
Badlands	Badlands	Badlands (Tengen)
BadlandsPete	BadlandsPete	Badlands Pete (ARC)
Bagitman	Bagitman	Bagitman (Bignonia)
Ballistix	Ballistix	Ballistix (Psyclases/Reflexions)
BaneOfCosmicForge	BaneOfCosmicForge	Bane of Cosmic Forge / Wizardry 6 (Sir-Tech)
BangkokKnights	BangkokKnights	Bangkok Knights (System 3)
Banshee	Banshee	Banshee (Core Design)
Barbarian	BarbarianPalace	Barbarian (Palace) (Palace)
Barbarian	Barbarian_Psygnosis	Barbarian (Psygnosis) (Psygnosis)
Barbarian2	Barbarian2Palace	Barbarian 2 / Axe of Rage (Palace)
Barbarian2	Barbarian2Psy	Barbarian 2 (Psygnosis/Pandemonium)
BardsTale	BardsTale	Bards Tale (Interplay)
BargonAttack	BargonAttack	Bargon Attack (Coktel Vision)
BartVsSpaceMutants	BartVsSpaceMutants	Bart vs. the Space Mutants (Acclaim/Ocean)
BartVsTheWorld	BartVsTheWorld	Bart vs. the World (Virgin)
BaseJumpers	BaseJumpers	Base Jumpers (Rasputin)
BasketIslandDemo1	BasketIslandDemo	Basket Island Demo (Syndrome)
BasketIslandDemo2	BasketIslandDemo	Basket Island Demo (Syndrome)
BAT	BAT	B.A.T. (UBI-Soft)
BAT2	BAT2	B.A.T. 2 (UBI-Soft)
BatmanCapedCrusader	Batman	Batman the Caped Crusader (Ocean)
BatmanReturns	BatmanReturns	Batman Returns (Konami/GameTek/Dentons)
BatmanTheMovie	BatmanTheMovie	Batman the Movie (Ocean)
BattleBound	BattleBound	Battle Bound (The Warp Factory)
BattleChess	BattleChess	Battle Chess (Interplay)
BattleChess2	BattleChess2	Battle Chess II: Chinese Chess (Interplay)
BattleCommand	BattleCommand	Battle Command (Ocean)
BattleForTheAshes	BattleForTheAshes	Battle For The Ashes (Audiogenic)
BattleHawks1942	BattleHawks1942	Battlehawks 1942 (Lucasfilm)
BattleIsle	BattleIsle	Battle Isle (Blue Byte)
BattleMaster	BattleMaster	Battle Master (PSS)
BattleShips	BattleShips	Battle Ships (Elite)
BattleSquadron	BattleSquadron	Battle Squadron (Innerprise)
BattleStorm	BattleStorm	Battle Storm (Titus)
BattleToads	BattleToads	Battle Toads (Mindscape)
BattleValley	BattleValley	Battle Valley (Hewson)
BCKid	BCKid	B.C.Kid (Factor 5)
BeachVolley	BeachVolley	Beach Volley (Ocean)
Beast2Demo	Beast2Demo	Shadow of the Beast 2 Demo (Psygnosis)
BeastBusters	BeastBusters	Beast Busters (Activision)
BeastDemo	BeastDemo	Shadow of the Beast Demo (Psygnosis)
BeastLord	BeastLord	Beast Lord (Grandslam)
Beavers	Beavers	Beavers (Grandslam)
BehindTheIronGate	BehindTheIronGate	Behind the Iron Gate (Ego)
Belial	Belial	Belial (Sector Software)
BeneathASteelSky	BeneathASteelSky	Beneath A Steel Sky (Virtual Theatre/Virgin)
Benefactor	Benefactor	Benefactor (Digital Illusions)
BestOfTheBest	BestOfTheBest	Best Of The Best (Loriciel/Futura)
Betrayal	Betrayal	Betrayal (Microprose)
BetterDeadThanAlien	BetterDeadThanAlien	Better Dead Than Alien (Electra)
BetterMaths	BetterMaths	Better Maths (School Software)
BeverlyHillsCop	BeverlyHillsCop	Beverly Hills Cop (Tynesoft)
BeyondDarkCastle	BeyondDarkCastle	Beyond Dark Castle (Activision)
BeyondTheIcePalace	BeyondTheIcePalace	Beyond the Ice Palace (Elite)
BezKompromisu	BezKompromisu	Bez Kompromisu (Mark Soft)
BigNoseTheCaveman	BigNoseTheCaveman	Big Nose the Caveman (Codemasters)
BigRun	BigRun	Big Run (Sales Curve)
Biing	Biing	Biing (reLINE)
BillsTomatoGame	BillsTomatoGame	Bill Tomato's Game (Psygnosis)
BioChallenge	BioChallenge	Bio Challenge (Delphine Software)
BionicCommando	BionicCommando	Bionic Commando (Go!/Software Creations)
BiplaneDuel	BiplaneDuel	Biplane Duel / Biplane Duel 2 / Salmon-Pink Max (Peter Mason)
BirdsOfPrey	BirdsOfPrey	Birds of Prey (Electronic Arts)
BlackCauldron	BlackCauldron	Black Cauldron (Sierra)
BlackCrypt	BlackCrypt	Black Crypt (Raven Software)
BlackLamp	BlackLamp	Black Lamp (Firebird)
BlackSect	BlackSect	Black Sect (Lankhor)
BlackShadow	BlackShadow	Black Shadow (CRL/Zen Room)
BlackTiger	BlackTiger	Black Tiger (Capcom/U.S.Gold)
BlackViper	BlackViper	Black Viper (Neo/LightShock)
BladeWarrior	BladeWarrior	Blade Warrior (Jason Kingsley/Imageworks)
Blastar	Blastar	Blastar (Core Design)
Blasteroids	Blasteroids	Blasteroids (Tengen/Image Works)
BlazingThunder	BlazingThunder	Blazing Thunder (Hi-Tec Software)
BlinkysScarySchool	BlinkysScarySchool	Blinkys Scary School (Zeppelin Games)
Blob	Blob	Blob (Core Design)
BlockOut	BlockOut	BlockOut (California Dreams)
BloodMoney	BloodMoney	Blood Money (Psygnosis)
Bloodnet	Bloodnet	Bloodnet (Microprose/GameTEK)
Bloodwych	Bloodwych	Bloodwych (Mirrorsoft)
Bloodwych&ExtendedLevels	Bloodwych&ExtendedLevels	Bloodwych (Mirrorsoft)
BlueAngel69	BlueAngel69	Blue Angel 69 (Magic Bytes)
BlueBerry	BlueBerry	Blue Berry (Infogrames)
BlueMax	BlueMax	Blue Max: Aces Of The Great War (Three-Sixty)
BluesBrothers	BluesBrothers	The Blues Brothers (Titus)
BMXSimulator	BMXSimulator	BMX Simulator (Code Masters)
Bobo	Bobo	Bobo (Infogrames)
BobsBadDay	BobsBadDay	Bob's Bad Day (Psygnosis/Dome Development)
BobsGarden	BobsGarden	Bob's Garden (Justin Leck)
BodyBlows	BodyBlows	Body Blows (Team 17)
BodyBlowsGalactic	BodyBlowsGalactic	Body Blows Galactic (Team 17)
BomberBob	BomberBob	Bomber Bob (Idea)
BombJack	BombJack	BombJack (Elite)
Bombuzal	Bombuzal	Bombuzal (Imageworks)
BombX	BombX	BombX ()
BonanzaBros	BonanzaBros	Bonanza Bros (Sega)
Booly	Booly	Booly (Loriciel)
Borobodur	Borobodur	Borobodur (Thalamus/EyesSoft)
BostonBombClub	BostonBombClub	Boston Bomb Club (Silmarils)
Botics	Botics	Botics (Krisalis)
BoulderDashConstKit	BoulderDashConstKit	Boulder Dash - Construction Kit (First Star)
Brainball	Brainball	Brainball (Traveling Bits)
BrainBlasters	TheTeller	The Teller / The Brain Blasters (UBI-Soft)
BrainMan	BrainMan	Brain Man (MegArts)
Brat	Brat	Brat (Imageworks)
Brataccas	Brataccas	Brataccas (Psygnosis)
Breathless	Breathless	Breathless (Fields of Vision)
BrianLarasCricket	BrianLarasCricket	Brian Lara's Cricket (Audiogenic)
BrianLarasCricket96	BrianLarasCricket96	Brian Lara's Cricket '96 (Audiogenic)
BrianTheLion	BrianTheLion	Brian the Lion (Psygnosis)
BridesOfDracula	BridesOfDracula	Brides of Dracula (Gonzo Games)
BrutalFootball	BrutalFootball	Brutal Football (Millennium/Teque)
BrutalPawsOfFury	BrutalPawsOfFury	Brutal Paws of Fury (GameTek)
BSSJaneSeymour	BSSJaneSeymour	B.S.S. Jane Seymour (Gremlin)
BubbaNStix	BubbaNStix	Bubba'n'Stix (Core Design)
Bubble&Squeak	BubbleNSqueak	Bubble And Squeak (Audiogenic)
Bubble+	Bubble+	Bubble + (Infogrames)
BubbleBobble	BubbleBobble	Bubble Bobble (Firebird)
BubbleDizzy	BubbleDizzy	Bubble Dizzy (Codemasters)
BubbleGun	BubbleGun	Bubble Gun (Weathermine Software)
BuckRogers	BuckRogers	Buck Rogers (TSR)
Budokan	Budokan	Budokan (Electronic Arts)
BuffaloBillsWildWestShow	BuffaloBill	Buffalo Bill's Wild West Show (Tynesoft)
BugBash	BugBash	Bug Bash (Mutation Software/Microtec Entertainment)
BugBomber	BugBomber	Bug Bomber (Kingsoft)
BuggyBoy	BuggyBoy	Buggy Boy (Elite)
BuilderLand	BuilderLand	Builderland: The Story Of Melba (Loriciel)
BumpNBurn	BumpNBurn	Bump'n Burn (Grandslam/Softeyes)
BumpysArcadeFantasy	BumpysArcadeFantasy	Bumpy's Arcade Fantasy (Loriciel)
BunnyBricks	BunnyBricks	Bunny Bricks (Silmarils)
BurgerMan	BurgerMan	Burger Man (Cloud Nine Developments)
BurningRubber	BurningRubber	Burning Rubber (Ocean)
Burntime	Burntime	Burntime (Max Design)
Baal	Baal	Baal (Psyclapse)
Cabal	Cabal	Cabal (Ocean)
CabaretAsteroids	CabaretAsteroids	Cabaret Asteroids (Vertical)
Cadaver	Cadaver	Cadaver (Imageworks/Bitmap Brothers)
CadaverLevels	CadaverLevels	Cadaver Demo Level (Bitmap Brothers)
CadaverThePayoff	Cadaver	Cadaver (Imageworks/Bitmap Brothers)
Calephar	Calephar	Calephar (Future)
CaliforniaGames	CaliforniaGames	California Games (Epyx/Westwood Associates)
CaliforniaGames2	CaliforniaGames2	California Games 2 (Epyx)
Campaign	Campaign	Campaign (Empire)
Campaign2	Campaign2	Campaign 2 (Empire)
CannonFodder	CannonFodder	Cannon Fodder (Sensible Software)
CannonFodder2	CannonFodder2	Cannon Fodder 2 (Sensible Software)
CannonFodder2AlienLevels	CannonFodder2AL	Cannon Fodder 2 - Alien Levels (Sensible Software)
CannonFodder2NVF	CannonFodder2NVF	Cannon Fodder 2 - Not Very Festive (Sensible Software)
CannonFodderCD	CannonFodderCD	"Cannon Fodder CD&sup3;&sup2; (Sensible Software)"
CannonFodderPlus	CannonFodderPlus	Cannon Fodder Plus (Sensible Software)
CannonSoccer	CannonSoccer	Cannon Soccer (Sensible Software/Amiga Format)
CapitalPunishment	CapitalPunishment	Capital Punishment (ClickBoom)
Capone	Capone	Capone (Actionware)
CaptainBlood	CaptainBlood	Captain Blood (Ere Informatique)
CaptainDynamo	Dynamo	Dynamo (Code Masters)
CaptainFizz	CaptainFizz	Captain Fizz (Psygnosis)
CaptainPlanet&ThePlaneteers	CaptainPlanet	Captain Planet (Mindscape)
Captive	Captive	Captive (Mindscape)
Carcharodon	Carcharodon	Carcharodon - White Sharks (Demonware)
Cardiaxx	Cardiaxx	Cardiaxx (Electronic Zoo/Team 17)
CarlLewisChallenge	CarlLewisChallenge	Carl Lewis Challenge (Psygnosis/Teque)
Carlos	Carlos	"Carlos (Micro&iuml;ds)"
CarmenWorld	CarmenWorld	"Where in the World is Carmen Sandiego (Br&oslash;derbund)"
Carnage	Carnage	Carnage (Zeppelin Games/Warped Minds)
CarrierCommand	CarrierCommand	Carrier Command (Realtime Games/Rainbird)
Carthage	Carthage	Carthage (Psygnosis)
CartonRouge	Anstoss	Anstoss / Carton Rouge (Ascon)
Cartoons	TheCartoons	The Cartoons (Loriciel)
Carver	Carver	Carver (Art Edition)
CarVup	CarVup	Car Vup (Core Design)
CastleKingdoms	CastleKingdoms	Castle Kingdoms (Mutation Software)
CastleMaster	CastleMaster	Castle Master (Incentive Software/Domark)
CastleMaster2	CastleMaster2	Castle Master 2 - The Crypt (Incentive/Domark)
CastleOfDrBrain	CastleOfDrBrain	Castle Of Dr. Brain (Sierra)
Castles	Castles	Castles (Interplay)
Castles2	Castles2	Castles 2: Siege and Conquest (Interplay)
CastleVania	CastleVania	Castle Vania (Konami)
CastleWarrior	CastleWarrior	Castle Warrior (Delphine Software)
CatchEm	CatchEm	Catch'em (Prestige Software)
Cavemania	Cavemania	CaveMania (Atlantis)
Cavitas	Cavitas	Cavitas (Nite Time Games)
Cedric	Cedric	Cedric (Neo/Alcatraz)
CelticLegends	CelticLegends	Celtic Legends (UBI-Soft)
CentrefoldSquares	CentrefoldSquares	Centrefold Squares (CDS)
Centurion	Centurion	Centurion: Defender Of Rome (Electronic Arts)
ChamberOfTheSciMutantPriestess	Kult	Kult / Chamber of the Sci-Mutant Priestess (Exxos/Infogrames)
ChambersOfShaolin	ChambersOfShaolin	Chambers of Shaolin (Thalion)
ChampionshipGolf	ChampionshipGolf	Championship Golf (Activision/GamesStar)
ChampionshipRun	VectorChampionshipRun	Vector Championship Run / Championship Run (Impulze/Zeppelin)
ChampionsOfKrynn	ChampionsOfKrynn	Champions Of Krynn (TSR/SSI)
ChaosEngine	ChaosEngine	Chaos Engine (Bitmap Brothers)
ChaosEngine2	ChaosEngine2	Chaos Engine 2 (Bitmap Brothers)
ChaosEngineDemo	ChaosEngineDemo	Chaos Engine Demo (Bitmap Brothers)
ChaosStrikesBack	ChaosStrikesBack	Chaos Strikes Back (FTL)
CharlieJCool	CharlieJCool	Charlie J. Cool (Nevada)
ChaseHQ	ChaseHQ	Chase H.Q. (Teque/Ocean)
ChaseHQ2	ChaseHQ2	Chase H.Q. 2 (Ocean/ICE)
Chessmaster2000	Chessmaster2000	Chessmaster 2000 (The Software Toolworks)
Chessmaster2100	Chessmaster2100	Chessmaster 2100 (The Software Toolworks)
ChessSimulator	ChessSimulator	Chess Simulator (Infogrames)
Chicago90	Chicago90	"Chicago 90 (Micro&iuml;ds)"
ChipsChallenge	ChipsChallenge	Chip's Challenge (Epyx)
Chrome	Chrome	Chrome (Gremlin)
ChroniclesOfOmega	ChroniclesOfOmega	Chronicles Of Omega (ARC)
ChronoQuest	Explora	Chrono Quest (Psygnosis)
ChronoQuest2	Explora2	Explora 2 / Chrono Quest 2 (Infomedia/Psygnosis)
ChubbyGristle	ChubbyGristle	Chubby Gristle (Grandslam/Teque)
ChuckieEgg	ChuckieEgg	Chuckie Egg (Pick and Choose)
ChuckieEgg2	ChuckieEgg2	Chuckie Egg 2 (Pick and Choose)
ChuckRock	ChuckRock	Chuck Rock (Core Design)
ChuckRock2	ChuckRock2	Chuck Rock 2 (Core Design)
ChuckYeagerAFT2	ChuckYeagerAFT2	Chuck Yeager AFT 2.0 (Eldrich the Cat)
CircusAttractions	CircusAttractions	Circus Attractions (Golden Goblins)
CircusGames	CircusGames	Circus Games (TyneSoft)
CiscoHeat	CiscoHeat	Cisco Heat (Imageworks)
Citadel	Citadel	Citadel (Arakkis/VD)
CityDefence	CityDefence	City Defence (KingSoft)
Civilization	Civilization	Civilization (Microprose)
CJInTheUSA	CJInTheUSA	CJ in the USA (Code Masters/Genesis)
CJsElephantAntics	CJsElephantAntics	CJ's Elephant Antics (Code Masters)
ClassicArcadia	ClassicArcadia	Classic Arcadia (Alternative Software)
ClassicBoardGames	ClassicBoardGames	Classic Board Games (Merit Software)
ClassicPucman	Pucman	Pucman (F1 Licenceware)
Cliffhanger	Cliffhanger	Cliffhanger (Psygnosis/Spidersoft)
ClikClak	ClikClak	Clik Clak (Idea)
CloudKingdoms	CloudKingdoms	Cloud Kingdoms (Millennium)
ClownOMania	ClownOMania	Clown'o'mania (Starbyte)
CluedoMasterDetective	CluedoMasterDetective	Cluedo: Master Detective (Leisure Genius)
Coala	Coala	Coala (Empire)
CodenameIceman	CodenameIceman	Codename: Iceman (Sierra)
Colgate	Colgate	Colgate (Silver Rock)
ColonelsBequest	ColonelsBequest	Colonel's Bequest (Sierra)
Colonization	Colonization	Colonization (Microprose)
Colorado	Colorado	Colorado (Silmarils)
Colorbuster	Colorbuster	Colorbuster (Indian Software)
CombatAirPatrol	CombatAirPatrol	Combat Air Patrol (Psygnosis)
ComboRacer	ComboRacer	Combo Racer (Gremlin)
Commando	Commando	Commando (Elite)
ComputerScrabble	ComputerScrabble	Computer Scrabble (Leisure Genius)
ConanTheCimmerian	ConanTheCimmerian	Conan the Cimmerian (Synergistic/Virgin)
Conqueror	Conqueror	Conqueror (Rainbow Arts)
ConquestsOfCamelot	ConquestsOfCamelot	Conquests of Camelot (Sierra)
ConquestsOfTheLongbow	ConquestsOfTheLongbow	Conquests Of The Longbow (Sierra)
ContinentalCircus	ContinentalCircus	Continental Circus (Taito)
CoolSpot	CoolSpot	Cool Spot (Virgin)
CoolWorld	CoolWorld	Cool World (Ocean)
Corporation	Corporation	Corporation (Core Design)
Corporation&Missions	Corporation&Missions	
Corruption	Corruption	Corruption (Magnetic Scrolls)
Corx	Corx	Corx (Starbyte)
CosmicBouncer	CosmicBouncer	Cosmic Bouncer (EuroLine/Ready Soft)
CosmicPirate	CosmicPirate	Cosmic Pirate (Palace)
CosmicRelief	CosmicRelief	Cosmic Relief / Terramex (Grandslam)
CosmicSpacehead	CosmicSpacehead	Cosmic Spacehead (Codemasters)
CountDuckula	CountDuckula	Count Duckula (Alternative Software)
CoverGirl	CoverGirl	Cover Girl (Emotional Pictures/Unreal Production)
CovertAction	CovertAction	Covert Action (Microprose)
Crack	Crack	Crack (Linel)
Crackdown	Crackdown	Crackdown (U.S.Gold)
CrazyCars	CrazyCars	Crazy Cars (Titus)
CrazyCars2	CrazyCars2_F40PursuitS	Crazy Cars 2 / F40 Pursuit Simulator (Titus)
CrazyCars3	CrazyCars3	Crazy Cars 3 (Titus)
CrazySeasons	CrazySeasons	Crazy Seasons (Proxima Design/Idea)
CrazyShot	CrazyShot	Crazy Shot (Hitech/Loriciel)
CrazySue	CrazySue	Crazy Sue (Hironymus Jumpshoe)
CrazySueGoesOn	CrazySue2	Crazy Sue 2 (Hironymus Jumpshoe)
Creature	Creature	Creature (Actionware)
Creatures	Creatures	Creatures (Thalamus)
CrimeWave	CrimeWave	Crime Wave (U.S.Gold)
CroisierePourUnCadavre	CruiseForACorpse	Cruise for a Corpse (Delphine Software)
CrossbowTheLegendOfWilliamTell	Crossbow	Crossbow (Screen 7/Intelligent Games)
CruiseForACorpse	CruiseForACorpse	Cruise for a Corpse (Delphine Software)
CruncherFactory	CruncherFactory	Cruncher Factory (Kingsoft)
CrystalDragon	CrystalDragon	Crystal Dragon (Magnetic Fields)
CrystalHammer	CrystalHammer	Crystal Hammer (Hannover)
CrystalKingdomDizzy	CrystalKingdomDizzy	Crystal Kingdom Dizzy (Code Masters)
CrystalPalace	CrystalPalace	Crystal Palace (Amiga Fun)
CrystalsOfArborea	CrystalsOfArborea	Crystals of Arborea (Silmarils)
Cubix	Cubix	Cubix (Media GmbH)
CurseOfEnchantia	CurseOfEnchantia	Curse of Enchantia (Core Design)
CurseOfRa	CurseOfRa	Curse of Ra (Rainbow Arts)
Custodian	Custodian	Custodian (Hewson)
CyberAssault	CyberAssault	Cyber Assault (Trojan)
Cyberball	Cyberball	Cyberball (Domark/Tengen)
Cyberblast	Cyberblast	Cyberblast (Innerprise)
Cybercon3	Cybercon3	Cybercon 3 (U.S.Gold)
CyberEmpires	CyberEmpires	Cyber Empires (Silicon Knights)
Cybernetix	Cybernetix	Cybernetix (Vision)
Cybernoid	Cybernoid	Cybernoid (Hewson)
Cybernoid2	Cybernoid2	Cybernoid 2 (Hewson)
Cyberpunks	Cyberpunks	Cyberpunks (Core Design)
Cyberzerk	Cyberzerk	Cyberzerk (Boeder)
Cytron	Cytron	Cytron (Psygnosis)
DalekAttack	DalekAttack	Dalek Attack (Alternative)
DaleyThompsonsOC	DaleyThompsonsOC	Daley Thompson's Olympic Challenge (Ocean)
Damocles	Mercenary2	Mercenary 2 - Damocles (Novagen)
Dandare3	Dandare3	Dan Dare 3 (Speed Buggy)
DangerousStreets	DangerousStreets	Dangerous Streets (Flair/Micromania)
Darius+	Darius	Darius+ (The Edge/Taito)
DarkCentury	DarkCentury	Dark Century (Titus)
DarkFusion	DarkFusion	Dark Fusion (Esprit Software/Gremlin)
Darkman	Darkman	Darkman (Ocean)
Darkmere	Darkmere	Darkmere (Core Design)
DarkSeed	DarkSeed	Darkseed (CyberDreams)
DarkSide	DarkSide	Dark Side (Incentive Software/Domark)
DataStorm	DataStorm	Data Storm (Visionary Design)
DaysOfThunder	DaysOfThunder	Days of Thunder (Mindscape)
DeathBringer	DeathBringer	Deathbringer (Empire) (Empire)
DeathBringer_Spotlight	DeathBringer_Spotlight	Death Bringer (Spotlight) (Spotlight Software)
DeathKnightsOfKrynn	DeathKnightsOfKrynn	Death Knights Of Krynn (SSI)
DeathMask	DeathMask	Death Mask (Alternative)
DeathOrGlory	DeathOrGlory	Death or Glory (Software 2000)
DeathSword	DeathSword	Death Sword (Palace/Epyx)
Deconstruction	Deconstruction	Deconstruction (Brain-Logo)
Deep	TheDeep	The Deep (Cream Corp/U.S.Gold)
DeepCore	DeepCore	Deep Core (ICE)
DeepSpace	DeepSpace	Deep Space (Psygnosis)
Defender	Defender	Defender (Giles.F.McArdell)
Defender2	Defender2	Defender 2 (Arc Developments)
DefenderOfTheCrown	DefenderOfTheCrown	Defender of the Crown (Cinemaware)
DefenderOfTheCrown2	DefenderOfTheCrown2	Defender Of The Crown 2 (Commodore)
DefendersOfTheEarth	DefendersOfTheEarth	Defenders of the Earth (Enigma Variations)
Deflektor	Deflektor	Deflektor (Gremlin)
Deliverance	Deliverance	Deliverance (21st Century)
DeluxeGalaga	DeluxeGalaga	Deluxe Galaga (Edgar M. Vigdal)
DeluxePacman	DeluxePacman	Deluxe Pacman (Edgar M.Vigdal)
DemonBlue	DemonBlue	Demon Blue (MicroValue)
Denaris	Denaris	Denaris (Factor 5)
Dennis	Dennis	Dennis (Ocean)
DenverColors	DenverColors	Je DÚcouvre Les Couleurs (Loriciel)
DesertStrike	DesertStrike	Desert Strike (Electronic Arts)
Deuteros	Deuteros	Deuteros (Ian Bird)
DeviousDesigns	DeviousDesigns	Devious Designs (Imageworks)
DGeneration	DGeneration	D/Generation (Mindscape)
DickTracy	DickTracy	Dick Tracy (Titus)
DickTracyAdventure	DickTracyAdv	Dick Tracy - The Crime Solving Adventure (Disney Soft/TouchStone)
DieHard2	DieHard2	Die Hard 2 (Grandslam)
Digger	Digger	Digger (Justin Leck)
Diggers	Diggers	Diggers (Millenium)
DimosQuest	DimosQuest	Dimo's Quest (Infernal Bytes/Boeder Software)
DinosaurDetectiveAgency	DinosaurDetectiveAgency	Dinosaur Detective Agency (Alternative Software)
Disc	Disc	Disc (Loriciel)
DisposableHero	DisposableHero	Disposable Hero (Euphoria/Gremlin Graphics)
DizzyCollection	DizzyCollection	Dizzy Collection (Code Masters)
DizzyDice	DizzyDice	Dizzy Dice (Smash 16)
DizzyPanic	DizzyPanic	Dizzy Panic (Code Masters)
DizzyPrinceOfTheYolkfolk	DizzyPrinceOfTheYolkfolk	Dizzy Prince of the Yolkfolk (Code Masters)
Dogfight	Dogfight	Dogfight (Microprose Ltd.)
DogsOfWar	DogsOfWar	Dogs of War (Elite Systems)
DojoDan	DojoDan	Dojo Dan (Europress)
Doman	Doman	Doman (World Software)
Dominator	Dominator	Dominator (System 3)
DonaldsAlphabetChase	DonaldsAlphabetChase	Donald's Alphabet Chase (Westwood Associates)
DonkeyKong	DonkeyKong	Donkey Kong (Bignonia)
DonkTheSamuraiDuck	Donk	Donk (The Hidden)
Doodlebug	Doodlebug	Doodlebug (Core Design)
Doofus	Doofus	Doofus (Prestige Software)
DoubleAgent	DoubleAgent	Double Agent (Flair)
DoubleDragon	DoubleDragon	Double Dragon (Ocean)
DoubleDragon2	DoubleDragon2	Double Dragon 2 - The Revenge (Virgin)
DoubleDragon3	DoubleDragon3	Double Dragon 3 (Sales Curve)
DownhillChallenge	SuperSki	"Super Ski / Eddie Edwards Super Ski / Downhill Challenge (Micro&iuml;ds/Loriciel/Br&oslash;derbund)"
Dracula	Dracula	Dracula (Psygnosis)
DragonBreed	DragonBreed	Dragon Breed (Irem/Activision)
DragonFighter	DragonFighter	Dragon Fighter (Idea)
Dragonflight	Dragonflight	Dragonflight (Thalion)
DragonNinja	DragonNinja	Dragon Ninja / Bad Dudes (Data East/Imagine)
DragonsBreath	DragonsBreath	Dragon's Breath (Palace Software)
Dragonscape	Dragonscape	Dragonscape (Free Spirit/Wicked Software)
DragonsKingdomDemo	DragonsKingdomDemo	Dragon's Kingdom Demo (GENIAS/GOLDEN TEAM)
DragonsLair	DragonsLair	Dragon's Lair (Readysoft)
DragonsLair2	DragonsLair2	Dragon's Lair 2 - Time Warp (Ready Soft)
DragonsLair3	DragonsLair3	Dragon's Lair 3 - The Curse of Mordread (Ready Soft)
DragonsLairEscapeDemo	DragonsLairEscapeDemo	Dragon's Lair: Escape from Singe's Castle Demo (Visionary Design)
DragonsLairEscapeFromSingesCastle	DragonsLairEscape	Dragon's Lair: Escape from Singe's Castle (Visionary Design)
DragonSpirit	DragonSpirit	Dragon Spirit (Domark)
Dragonstone	Dragonstone	Dragonstone (Core Design)
DragonStoneCD	DragonStoneCD	Dragonstone CD (Core Design)
DragonStrike	DragonStrike	Dragon Strike (Westwood/S.S.I)
DragonWars	DragonWars	Dragon Wars (Interplay)
Drakkhen	Drakkhen	Drakkhen (Infogrames)
DrDoomsRevenge	DrDoomsRevenge	Dr. Doom's Revenge (Empire)
DreamWeb	DreamWeb	Dream Web (Empire Software)
Driller	Driller	Driller (Incentive Software/Domark)
Drip	Drip	Drip (Art Skiles)
DrivingForce	DrivingForce	Drivin' Force (Digital Magic Software)
DrMario	DrMario	Dr. Mario (Trash Danmark)
Duck	Duck	Duck (Gremlin)
DuckTales	DuckTales	Duck Tales: The Quest for Gold (Disney Software)
Dune	Dune	Dune (Cryo)
Dune2	Dune2	Dune 2 (Westwood/Virgin Games)
DungeonMaster	DungeonMaster	Dungeon Master (FTL/Software Heaven)
DungeonMaster2	DungeonMaster2	Dungeon Master 2: The Legend of Skullkeep (Interplay)
DungeonsOfAvalon	DungeonsOfAvalon	Dungeons of Avalon (Zeret)
DungeonsOfAvalon2	DungeonsOfAvalon2	Dungeons of Avalon 2 (Zeret)
DylanDog	DylanDog	Dylan Dog: The Murderers (Simulmondo)
DynaBlaster	DynaBlaster	Dyna Blaster (Hudson Soft)
DynamiteDux	DynamiteDux	Dynamite Dux (Activision/Sega)
DynastyWars	DynastyWars	Dynasty Wars (U.S.Gold/Tiertex)
Dyter07	Dyter-07	Dyter-07 (reLINE)
EaglesRider	EaglesRider	"Eagles Rider (Micro&iuml;ds)"
Eco	Eco	Eco (Ocean)
EddTheDuck	EddTheDuck	Edd the Duck (BBC)
EddTheDuck2	EddTheDuck2	Edd the Duck 2 (Zeppelin Games)
Elf	Elf	Elf (Microvalue/Pumpkinsoft)
Elf_Ocean	Elf_Ocean	Elf (Ocean)
Elfmania	Elfmania	Elfmania (Terramarque/Renegade)
Eliminator	Eliminator	Eliminator (Hewson)
Elite	Elite	Elite (Mr. Micro)
EliteAdvanced	EliteAdvanced	Elite Advanced (Firebird/Rainbird/CARE)
Elvira	Elvira	Elvira - Mistress of the Dark (Horrorsoft/Accolade)
Elvira2	Elvira2	Elvira 2 - The Jaws of Cerberus (Horrorsoft/Accolade)
ElviraArcade	ElviraArcade	Elvira - The Arcade Game (Flair Software)
EmlynHughesIntSoccer	EmlynHughesIntSoccer	Emlyn Hughes International Soccer (Audiogenic)
Emmanuelle	Emmanuelle	Emmanuelle (TomaHawk)
E-Motion	E-Motion	E-Motion (Assembly Line/U.S.Gold)
EmpireSoccer94	EmpireSoccer94	Empire Soccer 94 (Graftgold/Empire)
EmpireStrikesBack	EmpireStrikesBack	Empire Strikes Back (Domark)
EnchantedLand	EnchantedLand	Enchanted Land (Thalion)
Encounter	Encounter	Encounter (Novagen)
Enemy	Enemy	Enemy - Tempest Of Violence (Anachronia)
EnglandChampSpecial	EnglandChampSpecial	England Championship Special (Grandslam)
Enlightenment	Enlightenment	Enlightenment (Bullfrog/Firebird)
Entity	Entity	Entity (Loriciel)
Epic	Epic	Epic (Ocean)
Epic&MissionDisk	Epic	Epic (Ocean)
Erik	Erik	Erik (Atlantis)
EscapeFromColditz	EscapeFromColditz	Escape from Colditz (Digital Magic Software)
EscapeFromThePlanet	EscapeFromThePlanet	Escape from the Planet of the Robot Monsters (Tengen/Teque)
Eskadra	Eskadra	Eskadra (LK Avalon/SUN Production)
EskimoGames	EskimoGames	Eskimo Games (Maitai/Magic Bytes)
EspanaTheGames	EspanaTheGames	Espana The Games '92 (Ocean/Creative Materials)
Eswat	Eswat	Eswat (U.S.Gold)
ETsRugbyLeague	ETsRugbyLeague	E.T.'s Rugby League (Audiogenic)
EuropeanChampions	EuropeanChampions	European Champions (Ocean)
EuropeanFootballChamp	EuropeanFootballChamp	European Football Champ (Domark)
Excalibur	Excalibur	Excalibur (King Soft)
Executioner	Executioner	Executioner (Codetapper)
Exile	Exile	Exile (Audiogenic)
Exolon	Exolon	Exolon (Hewson)
Explora	Explora	Explora (Infomedia)
Explora2	Explora2	Explora 2 / Chrono Quest 2 (Infomedia/Psygnosis)
Explora3	Explora3	Explora 3: Sous Le Signe Du Serpent (Infomedia)
Extase	Extase	Extase (Cryo/Virgin Losirs)
Exterminator	Exterminator	Exterminator (Audiogenic/Assembly Line)
Extractor	Extractor	Extractors: The Hanging Worlds Of Zarg (Millenium)
Extrial	Extrial	Extrial (Computer Verlag)
EyeOfHorus	EyeOfHorus	Eye of Horus (Britanica)
EyeOfTheBeholder	EyeOfTheBeholder	Eye of the Beholder (Westwood/SSI)
EyeOfTheBeholder2	EyeOfTheBeholder2	Eye of the Beholder 2 - The Legend of Darkmoon (Westwood/SSI)
F1	F1Racing	F1 Racing (Domark)
F15StrikeEagle2	F15StrikeEagle2	F-15 Strike Eagle 2 (Microprose)
F16CombatPilot	F16CombatPilot	F-16 Combat Pilot (Digital Integration)
F17Challenge	F17Challenge	F-17 Challenge (Team 17)
F19StealthFighter	F19StealthFighter	F-19 Stealth Fighter (Microprose)
F1Tornado	F1Tornado	F1 Tornado (Zeppelin Games/Quex Development)
F1WorldChampionshipEdition	F1WorldChampionship	F1 World Championship Edition (Domark)
F29Retaliator	F29Retaliator	F-29 Retaliator (Ocean)
F40PursuitSimulator	CrazyCars2_F40PursuitS	Crazy Cars 2 / F40 Pursuit Simulator (Titus)
FA18Interceptor	F-18Interceptor	F/A-18 Interceptor (Intellisoft/Electronic Arts)
FaeryTaleAdventure	FaeryTaleAdventure	Faery Tale Adventure (Microillusions)
Falcon	Falcon	Falcon (Spectrum HoloByte)
Falcon&MissionDisks	Falcon	Falcon (Spectrum HoloByte)
FantasticDizzy	FantasticDizzy	Fantastic Dizzy (Codemasters/Purple Haze)
FantasticVoyage	FantasticVoyage	Fantastic Voyage (Centaur Software)
FantasyFlyer	FantasyFlyer	Fantasy Flyer / Blue wings and soul dust (Gallica/Cobwebcut/Gabriel Leroy)
FantasyWorldDizzy	FantasyWorldDizzy	Fantasy World Dizzy (Code Masters)
Fascination	Fascination	Fascination (Coktel Vision)
FastFood	FastFood	Fast Food (Codemasters)
FastLane	FastLane	Fast Lane (Digital Integration)
FatalHeritage	FatalHeritage	Fatal Heritage (EGO/Delta Konzept)
FatmanTheCapedConsumer	FatmanTheCapedConsumer	Fatman - The Caped Consumer (Black Legend)
Fears	Fears	Fears (Bomb Software)
FederationOfFreeTraders	FederationOfFreeTraders	Federation of free Traders (Gremlin)
FernandezMustDie	FernandezMustDie	Fernandez Must Die (Mirrorsoft/Imageworks)
Feud	Feud	Feud (Bulldog)
FiendishFreddy	FiendishFreddy	Fiendish Freddy's Big Top'o Fun (Gray Matter/Mindscape)
FIFASoccer	FIFASoccer	FIFA Soccer (Electronic Arts)
FighterBomber	FighterBomber	Fighter Bomber (Activision)
FightinSpirit	FightingSpirit	Fightin' Spirit (Neo)
FinalAssault	FinalAssault	Final Assault (Epyx)
FinalBattle	FinalBattle	The Final Battle (Mirrorsoft)
FinalBlow	FinalBlow	Final Blow (Sales Curve)
FinalCountdown	FinalCountdown	Final Countdown (Demonware/Global Software)
FinalFight	FinalFight	Final Fight (Capcom)
Fire&Brimstone	FireAndBrimstone	Fire and Brimstone (Microprose)
Fire&Forget	FireAndForget	Fire and Forget (Titus)
Fire&Forget2	FireAndForget2	Fire And Forget 2 (Titus)
Fire&Ice	FireAndIce	"Fire &amp; Ice (Graftgold)"
Fire&IceXmasDemo	FireAndIce-XMas	"Fire &amp; Ice - Xmas (Graftgold)"
Fireblaster	Fireblaster	Fireblaster (Paradox Software)
FireForce	FireForce	Fire Force (ICE)
FireHawk	FireHawk	Fire Hawk (Codemasters)
FirePower	FirePower	FirePower (Silent Software/MicroIllusions)
FireStar	FireStar	Fire Star (Trojan)
FirstContact	FirstContact	First Contact (Chris Newcombe)
FirstSamurai	FirstSamurai	First Samurai (Vivid Image)
Fish	Fish	Fish (Magnetic Scrolls)
FistFighter	FistFighter	Fist Fighter (Zeppelin Games)
Flaschbier	Flaschbier	Flaschbier (Alpha Flight)
Flashback	Flashback	Flashback (Delphine Software)
FlightOfTheAmazonQueen	FlightOfTheAmazonQueen	Flight Of The Amazon Queen (Renegade)
FlimbosQuest	FlimbosQuest	Flimbos Quest (System 3)
FlinkCD	FlinkCD	"Flink CD&sup3;&sup2; (Psygnosis)"
FlipFlop	FlipFlop	Flip Flop (Kingsoft)
Flipit&Magnose	FlipItAndMagnose	"Flip-it &amp; Magnose (Expanding Minds/Mirrorsoft)"
Flood	Flood	Flood (Electronic Arts/Bullfrog)
FlyHarder	FlyHarder	Fly Harder (Starbyte)
FlyingShark	FlyingShark	Flying Shark (Taito/Firebird)
FoolsErrand	FoolsErrand	Fool's Errand (Miles Computing)
FootballerOfTheYear2	FootballerOfTheYear2	Footballer of the Year 2 (Gremlin)
FootballManagerWCE	FootballManagerWCE	Football Manager: World Cup Edition (Addictive)
ForgottenWorlds	ForgottenWorlds	Forgotten World (Arc Developments/Capcom)
Formula1GrandPrix	Formula1GrandPrix	Formula 1 Grand Prix (Cirrus Software/Tynesoft)
FormulaOneGrandPrix	FormulaOneGrandPrix	Formula One Grand Prix (Geoff Crammond/Microprose)
FourCrystalsOfTrazere	Legend	Legend / The four crystals of Trazere (Mindscape)
Frankenstein	Frankenstein	Frankenstein (Zeppelin Games)
Franko	Franko	Franko (World Software)
FranticFreddie	FranticFreddie	Frantic Freddie (Bignonia)
FreakOut	FreakOut	Freak Out (Zeret)
Fred	Fred	Fred (UBI-Soft)
Freedom	Freedom	Freedom (Coktel Vision)
Frenetic	Frenetic	Frenetic (Core Design)
FrightNight	FrightNight	Fright Night (Microdeal)
Frontier	Frontier	Frontier (GameTEK/Konami)
FrostByte	FrostByte	Frost Byte (Mikro-Gen)
FullContact	FullContact	Full Contact (Team 17)
FullMetalPlanete	FullMetalPlanete	Full Metal Planete (Hi-Tec)
FuryOfTheFurries	FuryOfTheFurries	Fury Of The Furries (Kalisto/Atreid software)
Fusion	Fusion	Fusion (Bullfrog)
FutureBasketBall	FutureBasketBall	Future BasketBall (Hewson)
FutureBike	FutureBike	Future Bike (Hi-Tec/PAL Developments)
FutureShock	FutureShock	Future Shock (Amiga Fun)
FutureTank	FutureTank	FutureTank (Timewarp)
FutureWars	FutureWars	Future Wars / Les Voyageurs Du Temps (Delphine Software)
Fuzzball	Fuzzball	Fuzzball (System 3)
Gainforce	Gainforce	Gainforce (Infernal Byte System)
GalacticConqueror	GalacticConqueror	Galactic Conqueror (Titus)
GalacticEmpire	GalacticEmpire	Galactic Empire (Coktel Vision/Tomahawk)
GalacticTheXmasEdition	Galactic	Galactic (Stavros Fasoulas)
GalacticWarriorRats	GalacticWarriorRats	Galactic Warrior Rats (Summit Software)
Galaga92	Galaga92	Galaga'92 (Cool-G)
Galaxy89	Galaxy89	Galaxy '89 (Kingsoft)
GalaxyBlast	GalaxyBlast	Galaxy Blast (Reaction)
GalaxyForce2	GalaxyForce2	Galaxy Force 2 (Activision/Dementia)
GaldregonsDomain	GaldregonsDomain	Galdregons Domain (Pandora)
GameOfHarmony	GameOfHarmony	Game Of Harmony (Assembly Line/Accolade/US Gold)
GamesSummerEdition	GamesSummerEdition	The Games: Summer Edition (Code Monkeys/Epyx/US Gold)
Ganymed	Ganymed	Ganymed (Euroline Software)
Garfield	Garfield	Garfield: Big, Fat, Hairy Deal (The Edge)
GarfieldAWintersTail	GarfieldAWintersTail	Garfield: A Winter's Tail (The Edge)
Garrison	Garrison	Garrison (Rainbow Arts/Digital Dreams)
Garrison2	Garrison2	Garrison 2 (Rainbow Arts/Digital Dreams)
GaryLinekersHotShot	GaryLinekersHotShot	Gary Lineker's Hot-Shot! (Gremlin)
Gauntlet2	Gauntlet2	Gauntlet 2 (Atari/U.S.Gold)
Gauntlet3	Gauntlet3	Gauntlet 3 (Tengen/U.S.Gold)
Gazza2	Gazza2	Gazza 2 (Empire)
GearWorks	GearWorks	Gear Works (Hollyware)
GeeBeeAirRally	GeeBeeAirRally	Gee Bee Air Rally (Activision)
Geisha	Geisha	Geisha (Cocktel Vision)
GeminiWing	GeminiWing	Gemini Wing (Sales Curve)
GemStoneLegend	GemStoneLegend	Gem Stone Legend (Loriciel)
GemX	GemX	Gem'X (Demonware/Kaiko)
Genesia	Genesia	"Genesia (Micro&iuml;ds)"
GhostBattle	GhostBattle	Ghost Battle (Thalion)
GhostBusters2	GhostBusters2	Ghost Busters 2 (Activision)
GhoulsNGhosts	GhoulsNGhosts	Ghouls'n'Ghosts (Capcom/U.S.Gold)
Giddy	Giddy	Giddy (Phil Ruston)
Giddy2	Giddy2	Giddy 2 (Phil Ruston)
GlobalGladiators	GlobalGladiators	Global Gladiators (Virgin)
GlobalTrekEvilDawn	GlobalTrekEvilDawn	Global Trek / Evil Dawn (ECP)
Globdule	Globdule	Globdule (Psygnosis)
Globulus	Globulus	Globulus (Innerprise)
GLOCR360	G-LOC	G-LOC (U.S.Gold)
GNius	GNius	G.Nius (Lankhor)
GnomeAlone	GnomeAlone	Gnome Alone (ICE)
Goal	Goal	Goal (Virgin)
Gobliiins	Gobliiins	Gobliiins (Cocktel Vision)
Gobliins2	Gobliins2	Gobliins 2 (Cocktel Vision)
Goblins3	Goblins3	Goblins 3 (Coktel Vision)
Godfather	Godfather	Godfather (U.S.Gold)
Gods	Gods	Gods (Bitmap Brothers)
GodsDemo	GodsDemo	Gods Demo (Bitmap Brothers)
GoldenAxe	GoldenAxe	Golden Axe (Virgin)
GoldenEagle	GoldenEagle	Golden Eagle (Loriciel)
GoldenPath	GoldenPath	Golden Path (Firebird)
GoldOfTheAztecs	GoldOfTheAztecs	Gold of the Aztecs (U.S.Gold)
Goldrunner	Goldrunner	Goldrunner (Microdeal)
Goldrunner2	Goldrunner2	Goldrunner 2 (Microdeal)
Goldrunner2&SceneryDisks	Goldrunner2	Goldrunner 2 (Microdeal)
GoldRush	GoldRush	Gold Rush (Sierra)
GoofysRailwayExpress	GoofysRailwayExpress	Goofy's Railway Express / Dingo Et Le Train Express / Il Rapido Di Pippo / El Tren Expreso Di Goofy / Goofy Und Der Phantastische Schnellzug (Westwood Associates)
GraemeSounessVectorSoccer	GraemeSounessVectorSoccer	Graeme Souness Vector Soccer (Impulse)
GrahamGooch2ndInnings	GrahamGooch2ndInnings	Graham Gooch Second Innings (Audiogenic)
GrahamGoochCricket	GrahamGoochCricket	Graham Gooch World Class Cricket (Audiogenic)
GrahamGoochTestMatchSE	GrahamGoochTestMatchSE	Graham Gooch Cricket: Test Match Special Edition (Audiogenic)
GrandMonsterSlam	GrandMonsterSlam	Grand Monster Slam (Rainbow Arts)
GrandPrix500II	GrandPrix500II	"Grand Prix 500 II / Hot Rubber (Micro&iuml;ds/Titus/Palace)"
GrandPrixMaster	GrandPrixMaster	Grand Prix Master / Aspar Master Grand Prix (Dinamic)
Gravity	Gravity	Gravity (Image Works)
GreatCourts	GreatCourts	Great Courts / Pro Tennis Tour (UBI-Soft)
GreatCourts2	GreatCourts2	Great Courts 2 / Pro Tennis Tour 2 (Blue Byte)
GreatGianaSisters	GianaSisters	Great Giana Sisters (Timewarp/Rainbow Arts)
Gremlins2	Gremlins2	Gremlins 2 (Elite)
GridRunner	GridRunner	Grid Runner / Super Grid Runner (Llamasoft)
GridStart	GridStart	Grid Start (Anco)
GSSoccerManager	GSSoccerManager	Graeme Souness Soccer Manager (Zeppelin)
GuardianAngel	GuardianAngel	Guardian Angel (Iron Byte/Codemasters)
GuardianCD	GuardianCD	"Guardian CD&sup3;&sup2; (Acid Software)"
GuildOfThieves	GuildOfThieves	The Guild of Thieves (Magnetic Scrolls)
GuldKornExpressen	GuldKornExpressen	Guld Korn Expressen (Silver Rock)
GunbeeF99	GunbeeF99	Gunbee F-99 ( APC TCP/Twin Eagles)
Gunship	Gunship	Gunship (Microprose)
Gunship2000	Gunship2000	Gunship 2000 (Microprose)
Gunshoot	Gunshoot	Gunshoot (Micropartner)
GuySpy	GuySpy	Guy Spy (Ready Soft)
Hacker	Hacker	Hacker (Activision)
Hacker2	Hacker2	Hacker 2: The Doomsday Papers (Activision)
HagarTheHorrible	Hagar	"H&auml;gar (KingSoft)"
HalleyProject	HalleyProject	The Halley Project (Mindscape)
Hammerboy	Hammerboy	Hammerboy (Dinamic)
Hammerfist	Hammerfist	Hammerfist (Vivid Image)
HardDrivin	HardDrivin	Hard Drivin' (Domark)
HardDrivin2	HardDrivin2	Hard Drivin' 2 (Domark)
HardNHeavy	HardNHeavy	Hard'n'Heavy (reLINE)
Harlequin	Harlequin	Harlequin (Gremlin)
HarleyDavidson	HarleyDavidson	Harley Davidson (Mindscape)
Harpoon&Battleset1	Harpoon	Harpoon (Three Sixty)
Harpoon&Battleset2	Harpoon	Harpoon (Three Sixty)
Harpoon&Battleset3	Harpoon	Harpoon (Three Sixty)
Harpoon&Battleset4	Harpoon	Harpoon (Three Sixty)
HATE	HATE	HATE (Gremlin)
Hawkeye	Hawkeye	Hawkeye (Thalamus)
HeadOverHeels	HeadOverHeels	Head over Heels (Ocean)
HeartOfTheDragon	HeartOfTheDragon	Heart Of The Dragon (Avatar Consulting)
HeavyMetal	HeavyMetal	Heavy Metal (Access)
HeavyMetalHeroes	HeavyMetalHeroes	Heavy Metal Heroes (Players)
Heimdall	Heimdall	Heimdall (Core Design)
Heimdall2	Heimdall2	Heimdall 2 (Core Design)
Hellbent	Hellbent	Hellbent (Novagen)
HellfireAttack	HellfireAttack	Hellfire Attack (Martech)
Hellraider	Hellraider	Hellraider (Atari)
HellrunMachine	HellrunMachine	Hellrun Machine (Amiga Fun)
HelterSkelter	HelterSkelter	Helter Skelter (Audiogenic)
HeroQuest	HeroQuest	Hero Quest (Gremlin)
HeroQuest&ReturnOfTheWitchLord	HeroQuest	Hero Quest (Gremlin)
HeroQuest2	HeroQuest2	Hero Quest 2 (Gremlin)
HerosQuest	QuestForGlory	Quest For Glory / Hero's Quest (Sierra)
HighSeasTrader	HighSeasTrader	High Seas Trader (Impressions)
HighSteel	HighSteel	High Steel (Screen 7)
HighwayHawks	HighwayHawks	Highway Hawks (Anco)
HighwayPatrol2	HighwayPatrol2	"Highway Patrol 2 (Titus/Micro&iuml;ds)"
Hillsfar	Hillsfar	Hillsfar (SSI)
HillStreetBlues	HillStreetBlues	Hill Street Blues (Krisalis)
Hilt	Hilt	Hilt (Scorpius Software)
Hilt2	Hilt2	Hilt 2 (Scorpius Software)
HiredGuns	HiredGuns	Hired Guns (Psygnosis)
HistoryLine	HistoryLine	History Line 1914-1918 (Blue Byte)
HoleInOne	HoleInOne	Hole In One (Digitek)
HolidayLemmings1993	LemmingsHoliday94	Lemmings - Holiday 1993/1994 (Psygnosis/DMA Design)
HolidayLemmings1994	LemmingsHoliday94	Lemmings - Holiday 1993/1994 (Psygnosis/DMA Design)
HolidayMaker	HolidayMaker	Holiday Maker (PM Entertainment/Software 2000)
HollywoodPoker	HollywoodPoker	Hollywood Poker (reLINE)
HollywoodPokerPro	HollywoodPokerPro	Hollywood Poker Pro (Softgold)
HongKongPhooey	HongKongPhooey	Hong Kong Phooey (Hi-Tec)
Hook	Hook	Hook (Ocean)
HorrorZombiesFromTheCrypt	HorrorZombies	Horror Zombies from the Crypt (Astralvision/Millennium)
Hostages	Hostages_OperationJupiter	Hostages / Operation Jupiter (Infogrames)
HotRod	HotRod	Hot Rod (Activision)
Hotshot	Hotshot	Hotshot (Prism Leisure Corporation)
HuckleberryHound	HuckleberryHound	Huckleberry Hound (Alternative)
HudsonHawk	HudsonHawk	Hudson Hawk (Ocean)
Hugo	Hugo	Hugo (Silverrock/ITE)
Hugo1	Hugo1	"Hugo - P&aring; Nye Eventyr (SilverRock)"
Hugo2	Hugo2	"Hugo - P&aring; Nye Eventyr 2 (SilverRock)"
HumanKillingMachine	HumanKillingMachine	Human Killing Machine (Go!)
Humans	Humans	The Humans (Imagitec Design)
Hunter	Hunter	Hunter (Activision)
HuntForRedOctober	HuntForRedOctober	Hunt for Red October (Grandslam)
Hybris	Hybris	Hybris (Discovery Software)
Hydra	Hydra	Hydra (Tengen/Domark)
Hyperion	Hyperion	Hyperion (Black Lengend/Offence software)
IceRunner	IceRunner	Ice Runner (Magic Soft)
IkariWarriors	IkariWarriors	Ikari Warriors (Elite)
Ilyad	Ilyad	Ilyad (UBI-Soft)
Immortal	Immortal	The Immortal (Electronic Arts)
Impact	Impact	Impact! (ASL)
Impact95	Impact	Impact! (ASL)
Imperium	Imperium	Imperium (Electronic Arts)
Impossamole	Impossamole	Impossamole (Gremlin/Core Design)
ImpossibleMission2	ImpossibleMission2	Impossible Mission 2 (Epyx)
ImpossibleMission2025	ImpossibleMission2025	Impossible Mission 2025 (Microprose)
IncredibleCrashDummies	IncredibleCrashDummies	Incredible Crash Dummies (Virgin/Acclaim)
IndianaJones	IndianaJones	Indiana Jones 3 - Arcade (Ocean)
IndianaJones&TheFateOfAtlantisAdventure	IndyFateOfAtlantis	"Indiana Jones &amp; The Fate of Atlantis (Lucasfilms Games)"
IndianaJones&TheLastCrusadeAdventure	IndyLastCrusade	"Indiana Jones &amp; The Last Crusade (Lucasfilm Games)"
Indianapolis500	Indianapolis500	Indianapolis 500 (Papyrus Design Group)
Indigo	Indigo	Indigo (Psygnosis/Stephane BELIN)
Indy4Action	Indy4Action	"Indiana Jones &amp; The Fate Of Atlantis Action (LucasArts)"
IndyHeat	IndyHeat	Indy Heat (Sales Curve)
IndyTempleOfDoom	IndyTempleOfDoom	"Indiana Jones &amp; The Temple of Doom (Lucasfilm Games/Atari/Mindscape)"
Infection	Infection	Infection (Virgin/Mastertronic)
Infestation	Infestation	Infestation (Psygnosis)
InsanityFight	InsanityFight	Insanity Fight (Microdeal)
InsectsInSpace	InsectsInSpace	Insects in Space (Hewson)
Intact	Intact	Intact (Sphinx Software/Grandslam)
Interchange	Interchange	Insector Hecti in the Inter Change (PAL Developments/Hi-Tec)
International3DTennis	International3DTennis	International 3D Tennis (Sensible Software/Palace)
InternationalIceHockey	InternationalIceHockey	International Ice Hockey (Impulze/Zeppelin)
InternationalKarate+	IK+	IK+ (Archer MacLean)
InternationalNinjaRabbits	InternationalNinjaRabbits	International Ninja Rabbits / Ninja Rabbits (Microvalue/Flair)
InternationalSoccer	InternationalSoccer	International Soccer (Zeppelin)
InternationalTruckRacing	InternationalTruckRacing	International Truck Racing (Zeppelin Games)
Interphase	Interphase	Interphase (Mirrorsoft)
IntoTheEaglesNest	IntoTheEaglesNest	Into the Eagle's Nest (Pandora)
Invasion	Invasion	Invasion (Sector Software)
Invest	Invest	Invest (Starbyte)
IronLord	IronLord	Iron Lord (UBI-Soft)
IronTrackers	IronTrackers	"Iron Trackers (Micro&iuml;ds/Prism Leisure)"
Ishar	Ishar	Ishar (Silmarils)
Ishar2	Ishar2	Ishar 2 (Silmarils)
Ishar3	Ishar3	Ishar 3 (Silmarils)
IslandOfLostHope	IslandOfLostHope	The Island Of Lost Hope (Digital Concepts)
ISS	ISS	Incredible Shrinking Sphere (Electric Dreams)
Italy1990	Italy1990	Italy 1990 Codemasters (Code Masters)
Italy1990WE	Italy1990WE	Italy 1990 U.S.Gold (U.S.Gold)
ItCameFromTheDesert	ItCameFromTheDesert	It Came From The Desert (Cinemaware)
Ivanhoe	Ivanhoe	Ivanhoe (Ocean)
JaguarXJ220	JaguarXJ220	Jaguar XJ-220 (Ocean)
JahangirKhansWorldChampionshipSquash	JahangirKhanSquash	Jahangir Khans World Championship Squash (Krisalis)
JamesBondTheStealthAffair	OperationStealth	Operation Stealth (Delphine Software)
JamesPond	JamesPond	James Pond - Underwater Agent (Millennium)
JamesPond2	JamesPond2	James Pond 2 - Robocod (Millennium)
JamesPond3	JamesPond3	James Pond 3 - Operation Starfish (Millennium/VectorDean)
JamesPond3CD	JamesPond3CD	"James Pond 3 - Operation Starfish CD&sup3;&sup2; (Millennium)"
Jaws	Jaws	Jaws (Screen 7/Intelligent Design)
JetSetWilly2	JetSetWilly2	Jet Set Willy 2 (Software Projects)
JetsonsTheComputerGame	Jetsons	Jetsons (PAL Developments/Hi-Tec)
JetStrike	JetStrike	Jetstrike (Rasputin)
JimmysFantasticJourney	JimmysFantasticJourney	Jimmy's Fantastic Journey (Europower Pack/Melon Dezign)
JimmyWhitesWhirlwindSnooker	JimmyWhitesWhirlwindSnooke	Jimmy White's Whirlwind Snooker (Virgin)
JimmyWillburne	JimmyWillburne	Jimmy Willburne (Chicken-Pox)
JimPower	JimPower	Jim Power (Loriciel)
Jinks	Jinks	Jinks (Diamond Software / Rainbow Arts)
Jinxter	Jinxter	Jinxter (Magnetic Scrolls)
JockyWilsonsDartsChallenge	JockyWilsonDartsChallenge	Jocky Wilson's Darts Challenge (Zeppelin)
Joe&MacCavemanNinja	JoeAndMac_CavemanNinja	"Joe &amp; Mac (Caveman Ninja) (Data East)"
JoeBlade	JoeBlade	Joe Blade (Players Software)
JoeBlade2	JoeBlade2	Joe Blade 2 (Players)
JohnMaddenFootball	JohnMaddenFootball	John Madden Football (Electronic Arts)
Jouster3	Jouster3	Jouster 3 (PawPrint Software)
JudgeDredd	JudgeDredd	Judge Dredd (Virgin/Random Access)
Jug	Jug	Jug (Microdeal)
JumpingJackSon	JumpingJackSon	Jumping Jack Son (Infogrames)
JumpNRoll	JumpNRoll	Jump'n'Roll (Amiga Fun)
JungleStrike	JungleStrike	Jungle Strike (Ocean)
JuniorTypist	JuniorTypist	Junior Typist (School Software)
JupitersMasterdrive	JupitersMasterdrive	Jupiter's Masterdrive (Ubi Soft)
JurassicPark	JurassicPark	Jurassic Park (Ocean)
K240	K240	K240 (Gremlin)
KalasPuffsExpressen	KalasPuffsExpressen	Kalas Puffs Expressen (Silver Rock)
Kamikaze	Kamikaze	Kamikaze (Codemasters)
KarateKid2	KarateKid2	Karate Kid 2 (Microdeal)
KarateKing&CityDefence	KarateKing	Karate King (King Soft)
KartingGrandPrix	KartingGrandPrix	Karting Grand Prix (Anco)
Katakis	Katakis	Katakis (Factor 5)
KellyX	KellyX	Kelly X (Virgin/Mastertronic)
KGB	KGB	KGB (Cryo)
KickOff	KickOff	Kick Off (ANCO)
KickOff&ExtraTime	KickOff	Kick Off (ANCO)
KickOff2	KickOff2	Kick Off 2 (Anco Software)
KidChaos	KidChaos	Kid Chaos (Ocean/Magnetic Fields)
KidGloves	KidGloves	Kid Gloves (Logotron)
KidGloves2	KidGloves2	Kid Gloves 2 (Millennium)
Kikstart2	Kikstart2	Kikstart 2 (Mastertronic)
Kikugi	Kikugi	Kikugi (Image Tech)
Killerball	Killerball	"Killerball (Micro&iuml;ds)"
KillingCloud	KillingCloud	Killing Cloud (Vektor Grafix)
KillingGameShow	KillingGameShow	Killing Game Show (Psygnosis)
KillingMachine	KillingMachine	Killing Machine (Atlantis)
KingOfChicago	TheKingOfChicago	The King Of Chicago (Cinemaware)
KingsQuest	KingsQuest	King's Quest (Sierra)
KingsQuest2	KingsQuest2	King's Quest 2 (Sierra)
KingsQuest3	KingsQuest3	King's Quest 3 (Sierra)
KingsQuest4	KingsQuest4	King's Quest 4 (Sierra)
KingsQuest5	KingsQuest5	King's Quest 5 (Sierra)
KingsQuest6	KingsQuest6	King's Quest 6 (Sierra)
KingsQuestEnhanced	KingsQuestEnhanced	King's Quest Enhanced (Sierra)
KirosQuest	KirosQuest	Kiros Quest (Vision)
Klax	Klax	Klax (Tengen)
KnightForce	KnightForce	Knight Force (Titus)
Knightmare	Knightmare	Knightmare (Mindscape)
KnightsOfTheCrystallion	KnightsOfTheCrystallion	Knights of the Crystallion (US Gold/Bill Williams)
KnightsOfTheSky	KnightsOfTheSky	Knights of the Sky (Microprose)
Kristal	TheKristal	The Kristal / Kristal, The (Addictive)
KrustysSuperFunHouse	KrustysSFH	Krusty's Super Fun House (Virgin)
KryptonEgg	KryptonEgg	Krypton Egg (HitSoft)
Kult	Kult	Kult / Chamber of the Sci-Mutant Priestess (Exxos/Infogrames)
Kwasimodo	Kwasimodo	Kwasimodo (Courbois Software)
KwikSnax	KwikSnax	Kwik Snax (Codemasters)
LamborghiniAmericanChallenge	Lamborghini	Lamborghini American Challenge (Titus)
Lancelot	Lancelot	Lancelot (Level 9)
LaserSquad	LaserSquad	Laser Squad (Teque)
LastActionHero	LastActionHero	Last Action Hero (Psygnosis)
LastBattle	LastBattle	Last Battle (Elite)
LastDuel	LastDuel	Last Duel (Capcom)
LastNinja2	LastNinja2	Last Ninja 2 (System 3)
LastNinja3	LastNinja3	Last Ninja 3 (System 3)
LeadingLap	LeadingLap	Leading Lap (Black Legend)
Leander	Leander	Leander (Psygnosis)
Leatherneck	Leatherneck	Leatherneck (Microdeal)
LeavinTeramis	LeavinTeramis	Leavin Teramis (Thalion)
LedStorm	LedStorm	LED Storm (Capcom/Software Creations)
Legend	Legend	Legend / The four crystals of Trazere (Mindscape)
LegendOfFaerghail	LegendOfFaerghail	Legend Of Faerghail (reLINE)
LegendOfKyrandia	LegendOfKyrandia	Legend Of Kyrandia (Westwood Studios)
LegendOfRagnarok	LegendOfRagnarok	Legend of Ragnarok (GameTek/Imagitec Design)
Legends	Legends	Legends (Krisalis)
LegendsOfValour	LegendsOfValour	Legends Of Valour (U.S.Gold)
LeisureSuitLarry	LeisureSuitLarry	Leisure Suit Larry (Sierra)
LeisureSuitLarry2	LeisureSuitLarry2	Leisure Suit Larry 2 (Sierra)
LeisureSuitLarry3	LeisureSuitLarry3	Leisure Suit Larry 3 (Sierra)
LeisureSuitLarry5	LeisureSuitLarry5	Leisure Suit Larry 5 (Sierra)
LeisureSuitLarryEnhanced	LeisureSuitLarryEnhanced	Leisure Suit Larry Enhanced (Sierra)
Lemmings	Lemmings	Lemmings (Psygnosis/DMA Design)
Lemmings2	Lemmings2	Lemmings 2 (Psygnosis)
LemmingsNewYear9192	LemmingsNewYear9192	New Year Lemmings 91/92 (Psygnosis)
LemmingsXmas91	LemmingsXmas91	Lemmings - X-Mas 1991 (Psygnosis)
LemmingsXmas92	LemmingsXmas92	Lemmings - X-Mas 1992 (Psygnosis)
Leonardo	Leonardo	Leonardo (Starbyte/The Golden Gate Crew)
LesManley	LesManley	Les Manley - Search For The King (Accolade)
LesPortesDuTemps	LesPortesDuTemps	Les Portes Du Temps (Legend)
LethalWeapon	LethalWeapon	Lethal Weapon (Ocean)
LethalXcess	LethalXcess	Lethal Xcess (Eclipse)
LethalZone	LethalZone	Lethal Zone (Infernal Byte System)
Leviathan	Leviathan	Leviathan (English Software)
LicenseToKill	LicenceToKill	Licence to Kill (Domark)
LifeAndDeath	LifeAndDeath	Life & Death (Software Toolworks/Mindscape)
LightCorridor	LightCorridor	Light Corridor (Infogrames)
LightRacer	LightRacer	Light Racer (A.Eberl & W.Singer)
Limes&Napoleon	LimesAndNapoleon	Limes & Napoleon (EAS)
LineOfFire	LineOfFire	Line of Fire (Sega/U.S.Gold)
Lionheart	Lionheart	Lionheart (Thalion)
LionheartDemo	LionheartDemo	Lionheart Demo (Thalion)
LionKing	LionKing	Lion King (Virgin)
LiquidKids	LiquidKids	Liquid Kids (Ocean)
LittleComputerPeople	LittleComputerPeople	Little Computer People (Activision)
LittlePuff	LittlePuff	Little Puff in Dragonland (Code Masters/Consult Software)
LiveAndLetDie	LiveAndLetDie	Live and let die / Space Harrier (Elite)
Llamatron	Llamatron	Llamatron (Jeff Minter/Llamasoft)
Logical	Logical	Logical (Rainbow Arts)
Logo	Logo	Logo (Starbyte)
LombardRACRally	LombardRACRally	Lombard RAC Rally (Red Rat/Mandarin Software)
Loom	Loom	Loom (Lucasfilm Games)
Loopz	Loopz	Loopz (Audiogenic/Mindscape)
LordsOfChaos	LordsOfChaos	Lords of Chaos (Blade)
LordsOfTheRealm	LordsOfTheRealm	Lords Of The Realm (Impressions)
LordsOfTheRisingSun	LordsOfTheRisingSun	Lords of the Rising Sun (Cinemaware)
LostDutchmanMine	LostDutchmanMine	Lost Dutchman Mine (Magnetic Scrolls)
LostPatrol	LostPatrol	Lost Patrol (Ocean)
LostVikings	LostVikings	The Lost Vikings (Interplay)
LotharMatthaus	LotharMatthaus	"Lothar Matth&auml;us (Ocean/Audiogenic)"
Lotus	LotusEspritTC	Lotus Esprit Turbo Challenge (Gremlin)
Lotus2	Lotus2	Lotus 2 (Magnetic Fields/Gremlin)
Lotus3	Lotus3	Lotus 3 (Magnetic Fields/Gremlin)
LunarC	LunarC	Lunar-C (Mindscape)
LureOfTheTemptress	LureOfTheTemptress	Lure of the Temptress (Virgin)
Luxor	Luxor	Luxor (Software Horizons Ltd/Paradox)
M1TankPlatoon	M1TankPlatoon	M1 Tank Platoon (Microprose)
Mach3	Mach3	Mach 3 (Loriciel)
MadProfessorMariarti	MadProfessorMariarti	Mad Professor Mariarti (Krisalis)
MadTV	MadTV	Mad TV (Rainbow Arts)
MagicBoy	MagicBoy	Magic Boy (Blue Turtle)
Magician	Magician	Magician (Loriciel)
MagiclandDizzy	MagiclandDizzy	Magicland Dizzy (Codemasters)
MagicLines	MagicLines	Magic Lines (Thalion)
MagicMarble	MagicMarble	Magic Marble (Sphinx)
MagicPockets	MagicPockets	Magic Pockets (Renegade/Bitmap Brothers)
MagicPocketsDemo	MagicPocketsDemo	Magic Pockets Demo (Bitmap Brothers)
Magnatron	Magnatron	Magnatron (BSP Design)
MajorMotion	MajorMotion	Major Motion (Microdeal)
ManFromTheCouncil	ManFromTheCouncil	Man From The Council (Pumpkinsoft/Tynesoft)
ManhattanDealers	ManhattanDealers	Manhattan Dealers / Operation Cleanstreets (Silmarils)
ManhattenDealers	ManhattanDealers	Manhattan Dealers / Operation Cleanstreets (Silmarils)
ManHunter	ManHunter	Manhunter (Sierra)
ManHunter2	ManHunter2	Man Hunter 2: San Francisco (Sierra)
ManiacMansion	ManiacMansion	Maniac Mansion (Lucasfilm Games)
Maniax	Maniax	Maniax (Kingsoft)
ManicMiner	ManicMiner	Manic Miner (Software Projects)
Manix	Manix	Manix (Millennium)
Marblelous	Marblelous	"Marblelous (APC &amp; TCP)"
MarbleMadness	MarbleMadness	Marble Madness (Atari/Electronic Arts)
MariasXMasBox	MariasXMasBox	Maria's XMas Box (Anco)
MarvinsMarvellousAdventure	MarvinsAdventure	Marvins Marvellous Adventure (21st Century Entertainment)
MasterAxe	MasterAxe	Master Axe (Epic)
MasterBlaster	MasterBlaster	Master Blaster (neXus Software)
MasterBlazer	MasterBlazer	Master Blazer (Rainbow Arts)
MatchOfTheDay	MatchOfTheDay	Match of the Day (Zeppelin Games)
MatrixMarauders	MatrixMarauders	Matrix Marauders (Psygnosis)
MaupitiIsland	MaupitiIsland	Maupiti Island (Lankhor)
Maya	Maya	Maya (Silmarils)
MaydaySquad	MaydaySquad	Mayday Squad (TyneSoft)
McDonaldLand	McDonaldLand	McDonald Land (Virgin)
MeanArenas	MeanArenas	Mean Arenas (ICE)
MeanMachine	MeanMachine	Mean Machine (Code Masters/Optimus Software)
MeanStreets	MeanStreets	Mean Streets (U.S.Gold)
MegaLoMania	MegaLoMania	Mega lo Mania (Sensible Software/Mirrorsoft)
MegaPhoenix	MegaPhoenix	Mega Phoenix (Dinamic)
Megatwins	Megatwins	Megatwins (U.S.Gold/SEGA)
MegaTyphoon	MegaTyphoon	Mega-Typhoon (Bernhardt Braun / Nordlicht Edv.)
Menace	Menace	Menace (DMA Design/Psygnosis)
MentalImage1	MentalImage1	Mental Image Game Disk 1 (Mental Image)
MentallImagesGameDisk2	MentallImagesGameDisk2	Mental Image Game Disk 2 (Mental Images)
Mercenary	Mercenary	Mercenary (Novagen)
Mercenary3	Mercenary3	Mercenary 3 - The Dion Crisis (Novagen)
MERCS	MERCS	MERCS (U.S.Gold)
MervTheMerciless	MervTheMerciless	Merv the Merciless (Probe Software)
MetalLaw	MetalLaw	Metal Law (New Bits on the Ram)
MetalMasters	MetalMasters	Metal Masters (Incal Product/Infogrames)
MetalMutant	MetalMutant	Metal Mutant (Silmarils)
MFTanks	MFTanks	MF Tanks (Magnetic Fields)
MiamiChase	MiamiChase	Miami Chase (Code Masters/Team 17)
Mickey123	Mickey123	Mickey's 123's: The BIG Surprise Party / Mickey 123: L'anniversaire surprise (Disney/DSI/Infogrames)
MickeyABC	MickeyABC	Mickey's ABC's: A Day at the Fair / Mickey ABC: Une journÚe Ó la fÛte (Disney/DSI/Infogrames)
MickeyJigsawPuzzles	MickeyJigsawPuzzles	Mickey's Jigsaw Puzzles / Mickey Puzzles AnimÞs (Disney/Novatrade/E.S.S./Infogrames)
MickeyMemoryChallenge	MickeyMemoryChallenge	Mickey Jeu de mÚmoire / Mickey's Memory Challenge (Disney/Infogrames)
MickeyMouse	MickeyMouse	Mickey Mouse (Gremlin)
Microbes	Microbes	Microbes (Vision)
Micromachines	Micromachines	Micromachines (Code Masters)
MicroproseGolf	MicroproseGolf	Microprose Golf (Microprose)
MicroproseSoccer	MicroproseSoccer	Microprose Soccer (Microprose)
MidnightResistance	MidnightResistance	Midnight Resistance (Ocean)
Midwinter	Midwinter	Midwinter (Rainbird)
Midwinter2	Midwinter2	Midwinter 2 (Maelstrom Games)
Mig29SovietFighter	Mig29SovietFighter	Mig-29 Soviet Fighter (Code Masters/Rapier Design)
MightAndMagic3	MightAndMagic3	Might & Magic III - Isles of Terra (New World Computing)
MightyBombjack	MightyBombjack	Mighty Bombjack (Elite)
Millennium2-2	Millennium2-2	"Millennium 2&middot;2 (Ian Bird)"
MindBender	MindBender	Mindbender (Gremlin)
MindRoll	MindRoll	Mind-Roll (Thalamus)
MindWalker	MindWalker	Mind Walker (Synapse)
MiniGolf	MiniGolf	Mini Golf (Magic Bytes)
MiniGolfPlus	MiniGolfPlus	Mini Golf Plus (Starbyte)
Minskies	Minskies	Minskie - The Abduction (Binary Emotions)
MissilesOverXerion	MissilesOverXerion	Missiles Over Xerion (Kingsoft/Cycletech)
MissionElevator	MissionElevator	Mission Elevator (Micropartner)
MonkeyIsland2	MonkeyIsland2	Monkey Island 2 (Lucasfilms Games)
MonsterBusiness	MonsterBusiness	Monster Business (Eclipse)
MontyPythonsFlyingCircus	MontyPythonsFlyingCircus	Monty Pythons Flying Circus (Core Design/Virgin)
MoonBlaster	MoonBlaster	Moon Blaster (Loriciel)
Moonfall	Moonfall	Moonfall (21st Century Entertainment)
MoonshineRacers	MoonshineRacers	Moonshine Racers (Millennium)
Moonstone	Moonstone	Moonstone (Mindscape)
MoonWalker	MoonWalker	Moon Walker (U.S.Gold/Emerald Software)
Morph	Morph	Morph (Millennium/Flair)
MortalKombat	MortalKombat	Mortal Kombat (Acclaim)
MortalKombat2	MortalKombat2	Mortal Kombat 2 (Acclaim)
MortvilleManor	MortvilleManor	Mortville Manor (Lankhor)
Mot	Mot	MOT (Opera Soft)
MotorbikeMadness	MotorbikeMadness	Motorbike Madness (Mastertronic)
Motorhead	Motorhead	"Mot&ouml;rhead (Virgin)"
MotorMassacre	MotorMassacre	Motor Massacre (Gray Matter/Gremlin)
Mousetrap	Mousetrap	Mousetrap (Micro Value/Tynesoft)
MrBlobby	MrBlobby	Mr.Blobby (Millennium/Freestyle)
MrDoRunRun	MrDoRunRun	Mr Do! Run Run (Electrocoin)
MrHeli	MrHeli	Mr.Heli (Firebird)
MrNutz	MrNutz	Mr.Nutz (Ocean)
MUDS	MUDS	M.U.D.S. (Rainbow Arts)
Murder	Murder	Murder (U.S.Gold)
MurdersInSpace	MurdersInSpace	Murders in Space (Infogrames)
Mystical	Mystical	Mystical (Infogrames)
Myth_MS	Myth_MS	Myth (Magnetic Scrolls)
MythHistoryInMaking	Myth	Myth (System 3)
Nam19651975	Nam1965-1975	NAM 1965-1975 (Domark)
Narc	Narc	Narc (Ocean)
NarcoPolice	NarcoPolice	Narco Police (Dinamic)
NaughtyOnes	NaughtyOnes	Naughty Ones (Interactivision)
NavyMoves	NavyMoves	Navy Moves (Dinamic)
NavySeals	NavySeals	Navy Seals (Ocean)
Nebulus	Nebulus	Nebulus (Hewson)
Nebulus2	Nebulus2	Nebulus 2 (21st Century)
Necronom	Necronom	Necronom (LineL)
Neighbours	Neighbours	Neighbours (Impulze/Zeppelin Games)
Netherworld	Netherworld	Netherworld (Hewson)
Neuromancer	Neuromancer	Neuromancer (Interplay)
NeverEndingStory2	NeverEndingStory2	Never Ending Story 2 (Linel)
Nevermind	Nevermind	Nevermind (Psyclapse)
NewYorkWarriors	NewYorkWarriors	New York Warriors (Arcadia Systems)
NewZealandStory	NewZealandStory	New Zealand Story (Taito/Ocean)
NickFaldosChampionshipGolf	NickFaldoGolf	Nick Faldo's Championship Golf (Grandslam)
Nicky2	NickyBoom2	"Nicky Boom 2 (Micro&iuml;ds)"
NickyBoom	NickyBoom	"Nicky Boom (Micro&iuml;ds)"
NigelMansellsGrandPrix	NigelMansellsGrandPrix	Nigel Mansell's Grand Prix (Martech)
NigelMansellWorldChamp	NigelMansellWorldChamp	Nigel Mansell's World Championship (Gremlin)
NightbreedAction	NightBreed	Night Breed (Action) (Ocean)
NightBreedMovie	NightBreedMovie	Night Breed (Movie) (Ocean)
Nightdawn	Nightdawn	Nightdawn (Magic Bytes)
NightHunter	NightHunter	Night Hunter (UBI-Soft)
NightShift	NightShift	Night Shift (Lucasfilm Games)
NinjaMission	NinjaMission	Ninja Mission (Mastertronic)
NinjaRemix	NinjaRemix	Ninja Remix (System 3)
NinjaSpirit	NinjaSpirit	Ninja Spirit (Mediagenic)
NinjaWarriors	NinjaWarriors	Ninja Warriors (Sales Curve)
NipponSafesInc	NipponSafesInc	Nippon Safes Inc (Dynabyte)
Nitro	Nitro	Nitro (Psygnosis)
NitroBoostChallenge	NitroBoostChallenge	Nitro Boost Challenge (Code Masters)
NoExcuses	NoExcuses	No Excuses (Arcana)
North&South	NorthAndSouth	"North &amp; South (Infogrames)"
NorthSeaInferno	NorthSeaInferno	North Sea Inferno (Parsec Software)
NoSecondPrize	NoSecondPrize	No Second Prize (Thalion)
Nova9	Nova9	Nova 9 (Dynamix)
NuclearWar	NuclearWar	Nuclear War (US Gold)
Nucleus	Nucleus	Nucleus (Mutation Software/Microtec Entertainment)
Oath	TheOath	The Oath (Attic)
Obitus	Obitus	Obitus (Psygnosis)
Obliterator	Obliterator	Obliterator (Psygnosis)
Obsession	Obsession	Obsession Pinball (Unique Development Sweden/Blade)
Odyssey	Odyssey	Odyssey (Audiogenic)
OffShoreWarrior	OffShoreWarrior	Off Shore Warrior (Titus)
OhNoMoreLemmings	LemmingsOhNoMore	Lemmings - Oh! No More (Psygnosis/DMA Design)
Oktagon	Octagon	Octagon ()
OneOnOne	OneOnOne	One On One (Electronic Arts)
OneStepBeyond	OneStepBeyond	One Step Beyond (Ocean)
Onslaught	Onslaught	Onslaught (Hewson)
OoopsUp	OoopsUp	Ooops Up (Demonware)
OperationCleanstreets	ManhattanDealers	Manhattan Dealers / Operation Cleanstreets (Silmarils)
OperationCombat2	OperationCombat2	Operation Combat II: By Land, Sea & Air (Merit Software)
OperationFirestorm	OperationFirestorm	Operation Firestorm (F1 Licenceware)
OperationG2Demo	OperationG2Demo	Operation GII Demo (Psygnosis)
OperationHarrier	OperationHarrier	Operation Harrier (U.S.Gold)
OperationJupiter	Hostages_OperationJupiter	Hostages / Operation Jupiter (Infogrames)
OperationNeptune	OperationNeptune	Operation Neptune (Infogrames)
OperationStealth	OperationStealth	Operation Stealth (Delphine Software)
OperationThunderbolt	OperationThunderbolt	Operation Thunderbolt (Ocean)
OperationWolf	OperationWolf	Operation Wolf (Ocean)
OrbitalDestroyer	OrbitalDestroyer	Orbital Destroyer (Trojan)
OrientalGames	OrientalGames	Oriental Games (MicroStyle/MicroProse)
Ork	Ork	Ork (Psygnosis)
Oscar	Oscar	Oscar (Flair Software)
OsWALDOfTheIceFloes	OsWALDOfTheIceFloes	OsWALD Of The Ice Floes (Centaur)
OutOfThisWorld	AnotherWorld	Another World / Out of this World (Delphine Software)
OutRun	OutRun	OutRun (Sega)
OutRunEuropa	OutrunEurope	OutRun Europe (U.S.Gold/Probe)
Outzone	Outzone	Outzone (Lankhor)
Overdrive	Overdrive	Overdrive (Team 17)
Overkill	Overkill	Overkill (Mindscape)
Overlander	Overlander	Overlander (Elite)
Overlord	Overlord	Overlord (Rowan) (Rowan/Virgin)
OverTheNet	OverTheNet	Over The Net (Genias)
Oxxonian	Oxxonian	Oxxonian (Time Warp)
P47Thunderbolt	P47Thunderbolt	P47 Thunderbolt (Firebird)
Pacland	Pacland	Pacland (Grandslam)
Pacmania	Pacmania	Pacmania (Grandslam)
Pandora	Pandora	Pandora (Firebird)
Pang	Pang	Pang (Ocean)
PanzaKickboxing	PanzaKickboxing	Panza Kickboxing (Loriciel/Futura)
Paperboy	Paperboy	Paperboy (Atari)
Paperboy2	Paperboy2	Paperboy 2 (Mindscape/Tengen)
Paradroid90	Paradroid90	Paradroid 90 (Hewson/Graftgold)
Paragliding	Paragliding	Paragliding (Loriciel)
Paramax	Paramax	Paramax (Kingsoft)
ParasolStars	ParasolStars	Parasol Stars (Ocean)
PassingShot	PassingShot	Passing Shot (Imageworks)
Patrician	Patrician	The Patrician / Der Patrizier (Ascon)
Pegasus	Pegasus	Pegasus (Gremlin)
Perihelion	Perihelion	Perihelion (Psygnosis)
PersianGulfInferno	PersianGulfInferno	Persian Gulf Inferno (Parsec Software)
PeterBeardsleys	PeterBeardsleys	Peter Beardsley's International Football (Teque/Grandslam)
PeterSchmeichelSoccer	PeterSchmeichelSoccer	Peter Schmeichel Soccer (Zeppelin)
PGAEuropeanTour	PGAEuropeanTour	PGA European Tour (The Dome/Ocean)
Phalanx	Phalanx	Phalanx (King Soft)
Phantasie3	Phantasie3	Phantasie 3: The Wrath of Nikademus (SSI)
PhantomFighter	PhantomFighter	Phantom Fighter (Emerald Software)
PharaohsCurse	PharaohsCurse	Pharaoh's Curse (Bignonia)
Phobia	Phobia	Phobia (Mirrorsoft/Imageworks)
PhotonStorm	PhotonStorm	Photon Storm (Arc Developments)
PicknPile	PicknPile	Pick 'n' Pile (Ubi Soft)
PierreLeChefIsOutToLunch	OutToLunch	Out To Lunch (Mindscape)
PinballBrainDamage	PinballBrainDamage	Pinball Brain Damage (Mind's Eye)
PinballDreams	PinballDreams	Pinball Dreams (Digital Illusions)
PinballFantasies	PinballFantasies	Pinball Fantasies (21st Century)
PinballHazard	PinballHazard	Pinball Hazard (Mirage/Magic Image)
PinballIllusions	PinballIllusions	Pinball Illusions (Digital Illusions/21st Century)
PinballMagic	PinballMagic	Pinball Magic (Loriciel)
PinballMania	PinballMania	Pinball Mania (21st Century Entertainment)
PinballPrelude	PinballPrelude	Pinball Prelude (Effigy)
PinballWizard	PinballWizard	Pinball Wizard (H.G.Berg/Kingsoft)
Pinkie	Pinkie	Pinkie (Millennium)
PinkPanther	PinkPanther	Pink Panther (reLINE)
PipeDream	PipeDream	Pipe Dream (Lucasfilm Games)
Pipeline	Pipeline	Pipeline (Softworx)
PipeMania	PipeMania	Pipe Mania (Empire/The Assembly Line)
Pirates	Pirates	Pirates! (Microprose)
Pitfighter	Pitfighter	Pitfighter (Domark/Teque)
Plague	Plague	Plague (Innerprise)
Plan9FromOuterSpace	Plan9FromOuterSpace	Plan 9 From Outer Space (Gremlin Graphics)
Platoon	Platoon	Platoon (Ocean)
Playroom	Playroom	"Playroom (Br&oslash;derbund/Infogrames)"
Plotting	Plotting	Plotting (Ocean)
Plutos	Plutos	Plutos (Micro Value)
Pod	Pod	Pod (Shaun Southern)
PokerNights	PokerNights	Poker Nights: Teresa Personally (Verlag Teresa Orlowski/Escal Software)
PoliceQuest	PoliceQuest	Police Quest (Sierra)
PoliceQuest2	PoliceQuest2	Police Quest 2 (Sierra)
PoliceQuest3	PoliceQuest3	Police Quest 3 (Sierra)
Pong	Pong	Pong (Claudio Buraglio)
Pool	Pool	Pool (Mastertronic)
PoolOfRadiance	PoolOfRadiance	Pool Of Radiance (SSI)
Popeye2	Popeye2	Popeye 2 (Alternative)
Populous	Populous	Populous (Bullfrog)
Populous&DataDisks	Populous	Populous (Bullfrog)
Populous2	Populous2	Populous 2 (EOA/Bullfrog)
Populous2&ChallengeGames	Populous2	Populous 2 (EOA/Bullfrog)
PopulousWorldEditor	PopulousWorldEditor	Populous World Editor (Bullfrog)
Portal	Portal	Portal (Activision)
PortsOfCall	PortsOfCall	Ports Of Call (International Software Development)
PostmanPat	PostmanPat	Postman Pat (Alternative)
POW	POW	P.O.W. (Actionware)
Power	ThePower	The Power (Demonware)
PowerDrift	PowerDrift	Power Drift (Activision)
Powerdrive	Powerdrive	Powerdrive (Rage Software/U.S.Gold)
Powerdrome	Powerdrome	Powerdrome (Electronic Arts)
Powermonger	Powermonger	Powermonger (Bullfrog)
PowermongerWW1Edition	PowermongerWW1	Powermonger World War I (Bullfrog)
PowerPinball	PowerPinball	Power Pinball (KarmaSoft)
PowerPlay	PowerPlay	Powerplay: The Game of the Gods (Arcana)
Powerstyx	Powerstyx	Powerstyx (DigiTek Software)
PPHammer	PPHammer	PP Hammer (Demonware)
Predator	Predator	Predator (Activision)
Predator2	Predator2	Predator 2 (Konami)
PrehistoricTale	PrehistoricTale	Prehistoric Tale (Thalion)
Prehistorik	Prehistorik	Prehistorik (Titus)
Premiere	Premiere	Premiere (Core Design)
PrimalRage	PrimalRage	Primal Rage (Atari/Time Warner Interactive)
PrimeMover	PrimeMover	Prime Mover (Psygnosis)
PrinceDePerse	PrinceOfPersia	"Prince of Persia (Jordan Mechner/Br&oslash;derbund)"
PrinceOfPersia	PrinceOfPersia	"Prince of Persia (Jordan Mechner/Br&oslash;derbund)"
Prison	Prison	Prison (Krisalis/Actionware)
ProBoxingSimulator	ProBoxingSimulator	Pro Boxing Simulator (Code Masters/Optimus Software)
ProjectX	ProjectX	Project X (Team 17)
ProjectXSE	ProjectXSE	Project X - Special Edition (Team 17)
Projectyle	Projectyle	Projectyle (Eldrich the Cat)
Prophecy1VikingChild	VikingChild	Prophecy: The Viking Child (Imagitec Design)
ProPowerBoatSimulator	ProPowerBoatSimulator	Pro PowerBoat Simulator (Codemasters)
ProSoccer2190	ProSoccer2190	Pro Soccer 2190 (Vulture)
ProspectorMazesOfXor	ProspectorMazesOfXor	Prospector in the Mazes of Xor (Hidden Treasures/Logotron)
ProTennisSimulator	ProTennisSimulator	Pro Tennis Simulator (Code Masters)
Psyborg	Psyborg	Psyborg (Loriciel)
PsychoSanta	PsychoSanta	Psycho Santa (Bullfrog)
PubTriviaSimulator	PubTriviaSimulator	Pub Trivia Simulator (Code Masters)
PuffysSaga	PuffysSaga	Puffy's Saga (UBI-Soft)
Puggsy	Puggsy	Puggsy (Psygnosis)
PulsatorDemo	PulsatorDemo	Pulsator Demo (APC & TCP/Fullspeed)
PurpleSaturnDay	PurpleSaturnDay	Purple Saturn Day (Exxos)
Pushover	Pushover	Pushover (Red Rat Software/Ocean)
Putty	Putty	Putty (System 3)
PuttySquadDemo	PuttySquadDemo	Putty Squad Demo (System 3)
Puzznic	Puzznic	Puzznic (Ocean)
Pyramax	Pyramax	Pyramax (Arc)
QBic	QBic	QBic (Ronald Pieket Weeserik)
Quadralien	Quadralien	Quadralien (Logotron/Astral Software)
Quadrel	Quadrel	Quadrel (Loriciel)
Quartz	Quartz	Quartz (Loriciel)
QuestForGlory	QuestForGlory	Quest For Glory / Hero's Quest (Sierra)
QuestForGlory2	QuestForGlory2	Quest For Glory 2 - Trial By Fire (Sierra)
QuestForTheTimeBird	TheQuestForTheTimeBird	"The Quest For The Time Bird / Auf der Suche nach dem Vogel der Zeit / La qu&ecirc;te de l'oiseau du temps (Infogrames)"
QuestionOfSport	QuestionOfSport	Question of Sport (Elite)
QuestOfAgravain	QuestOfAgravain	Quest of Agravain (Code Masters)
Questron2	Questron2	Questron 2 (SSI)
QueteDeLOiseauDuTemps	TheQuestForTheTimeBird	The Quest For The Time Bird / Auf der Suche nach dem Vogel der Zeit / La quête de l'oiseau du temps (Infogrames)
QuikTheThunderRabbit	Quik	Quik (Stywos/Titus)
Qwak	Qwak	Qwak (Team 17)
RaceDrivin	RaceDrivin	Race Drivin' (Domark)
RackneysIsland	RackneysIsland	Rackney's Island (Megatronix)
Racter	Racter	Racter (Inrac)
Raffles	Raffles	Raffles (The Edge/Softek)
Rage2	Rage2	Rage 2.0 (Gabriel LEROY)
RageCAD	RageCAD	Rage (CAD/Ubi Soft)
Raider	Raider	Raider (Celestial Software/Impressions)
RailroadTycoon	RailroadTycoon	Railroad Tycoon (Microprose)
RainbowIslands	RainbowIslands	Rainbow Islands (Ocean)
RainbowWarrior	RainbowWarrior	Rainbow Warrior (Micro Style)
RallyCrossChallenge	RallyCrossChallenge	Rally Cross Challenge (Ultra Graphix/Anco)
Rambo3	Rambo3	Rambo 3 (Ocean)
Rampage	Rampage	Rampage (Activision)
Rampart	Rampart	Rampart (Domark)
RanX	RanX	RanX (UBI-Soft)
RatTrap	RatTrap	Rat Trap (Audiogenic)
RBI2Baseball	RBI2Baseball	RBI 2 Baseball (Domark)
RealGhostbusters	RealGhostbusters	Real Ghostbusters (Activision)
Realms	Realms	Realms (Graftgold)
RealmsOfArkania	RealmsOfArkania	Realms Of Arkania: Blade Of Destiny / Das Schwarze Auge: Die Schicksalsklinge (Fantasy/Schmidt Spiele)
RealPopeye	TheRealPopeye	The Real Popeye (Bignonia)
RedBaron	RedBaron	Red Baron (Dynamix)
RedHeat	RedHeat	Red Heat (Ocean)
RedLightning	RedLightning	Red Lightning (S.S.I.)
RedStormRising	RedStormRising	Red Storm Rising (MicroProse)
RedZone	RedZone	Red Zone (Psygnosis)
Reflexity	Reflexity	Reflexity (Hi-Tec)
Renaissance	Renaissance	Renaissance / Classic 4 (Impressions)
Renegade	Renegade	Renegade (Taito)
Renegade3	Renegade3	Renegade 3 (A.Mastromarino & J.Lewis)
Renegades	Renegades	Renegades (Infernal Byte Systems)
Resolution101	Resolution101	Resolution 101 (Millennium)
ReturnOfTheJedi	ReturnOfTheJedi	Return of the Jedi (Domark)
ReturnToGenesis	ReturnToGenesis	Return to Genesis (Firebird)
Revelation	Revelation	Revelation (Krisalis)
RevengeOfDefender	RevengeOfDefender	Revenge of Defender (Epyx/Logotron)
RevengeOfTheMutantCamels	RevengeCamels	Revenge of the Mutant Camels (Jeff Minter)
RickDangerous	RickDangerous	Rick Dangerous (Core Design)
RickDangerous2	RickDangerous2	Rick Dangerous 2 (Core Design)
RingSideBoxing	RingSideBoxing	Ring Side Boxing (Microdeal)
RingsOfMedusa	RingsOfMedusa	Rings Of Medusa (Starbyte)
RiseOfTheDragon	RiseOfTheDragon	Rise Of The Dragon (Dynamix)
RiseOfTheRobots	RiseOfTheRobots	Rise of the Robots (Mirage/Time Warner)
Risk	Risk	Risk (Virgin)
RiskyWoods	RiskyWoods	Risky Woods (Electronic Arts/Dinamic)
RoadBlasters	RoadBlasters	Road Blasters (US Gold)
RoadKill	RoadKill	Road Kill (Vision)
RoadRash	RoadRash	Road Rash (Electronic Arts Racing)
RoadWars	RoadWars	Road Wars (Arcadia Systems)
RobinHoodLegendQuest	RobinHoodLegendQuest	Robin Hood: Legend Quest (Codemasters)
RobinsonsRequiem	RobinsonsRequiem	Robinson's Requiem (Silmarils)
RoboCop	RoboCop	RoboCop (Ocean)
RoboCop2	RoboCop2	RoboCop 2 (Ocean)
RoboCop3	RoboCop3	RoboCop 3 (Ocean)
RocketRanger	RocketRanger	Rocket Ranger (Cinemaware)
Rockford	Rockford	Rockford (Arcadia)
RocknRoll	RocknRoll	Rock'n'Roll (Rainbow Arts)
RockStarAteMyHamster	RockstarHamster	Rockstar Ate My Hamster! (Colin Jones/Code Masters)
Rodland	Rodland	Rodland (Sales Curve)
RodyAndMastico	RodyAndMastico	"Rody &amp; Mastico (Lankhor)"
RodyAndMastico2	RodyAndMastico2	"Rody &amp; Mastico 2 (Lankhor)"
RodyAndMastico3	RodyAndMastico3	"Rody &amp; Mastico 3 (Lankhor)"
RodyAndMastico4RodyNoel	RodyAndMastico4RodyNoel	"Rody &amp; Mastico 4 - Rody Noel (Lankhor)"
RodyAndMastico5	RodyAndMastico5	"Rody &amp; Mastico 5 (Lankhor)"
RodyAndMastico6	RodyAndMastico6	"Rody &amp; Mastico 6 (Lankhor)"
RogueTrooper	RogueTrooper	Rogue Trooper (Krisalis)
Roketz	Roketz	Roketz (The Farm)
RollerCoasterRumbler	RollerCoasterRumbler	Roller Coaster Rumbler (Tynesoft)
RollingRonny	RollingRonny	Rolling Ronny (Starbyte/Virgin)
RollOrDie	RollOrDie	Roll or Die (Animators)
RomeAd92	RomeAd92	Rome AD 92 (Millennium)
Rotor	Rotor	Rotor (Arcane)
Rotox	Rotox	Rotox (U.S.Gold)
RoundTheBend	RoundTheBend	Round the Bend (Zeppelin)
RType	RType	R-Type (Rainbow Arts)
RType2	RType2	R-Type 2 (Activision)
Rubicon	Rubicon	Rubicon (21st Century)
Ruff&ReddyInTheSpaceAdventure	RuffAndReddy	Ruff and Reddy (Hi-Tec/PAL Developments)
Ruffian	Ruffian	Ruffian (Ruffian Software)
RuffNTumble	RuffNTumble	Ruff'n'Tumble (Renegade)
RugbyTheWorldCup	RugbyTheWorldCup	Rugby the World Cup (Domark)
RunningMan	RunningMan	Running Man (Grandslam)
RunTheGauntlet	RunTheGauntlet	Run the Gauntlet (Ocean)
RushHour	RushHour	Rush Hour (Amiga Fun)
RVFHonda	RVFHonda	RVF Honda (Micro Style)
SabreTeam	SabreTeam	Sabre Team (Krisalis)
SafariGuns	SafariGuns	Safari Guns / On Safari (New Deal Productions)
SaintAndGreavsie	SaintAndGreavsie	Saint & Greavsie (Core Design/Gremlin)
SaintDragon	SaintDragon	Saint Dragon (Ocean)
SalmonPinkMax	BiplaneDuel	Biplane Duel / Biplane Duel 2 / Salmon-Pink Max (Peter Mason)
SantasXmasCaper	SantasXmasCaper	Santa's Xmas Caper (Zeppelin)
Sarakon	Sarakon	Sarakon (Starbyte)
Sarcophaser	Sarcophaser	Sarcophaser (Rainbow Arts)
SASCombatSimulator	SASCombatSimulator	SAS Combat Simulator (Code Masters)
Satan	Satan	Satan (Dinamic)
Savage	Savage	Savage (Probe Software)
SchwarzeAuge	RealmsOfArkania	Realms Of Arkania: Blade Of Destiny / Das Schwarze Auge: Die Schicksalsklinge (Fantasy/Schmidt Spiele)
ScoobyDoo	ScoobyDoo	Scooby-Doo (Hi-Tec)
Scorpio	Scorpio	Scorpio (KingSoft)
Scorpion	Scorpion	Scorpion / Fly Fighter (Digital Magic Software)
Scrabble	Scrabble	Scrabble (US Gold)
ScrambleSpirits	ScrambleSpirits	Scramble Spirits (Grandslam/Teque)
ScrollingWalls	ScrollingWalls	Scrolling Walls (KingSoft)
SecondSamurai	SecondSamurai	Second Samurai (Psygnosis/Vivid Image)
SecondsOut	SecondsOut	Seconds Out (TyneSoft)
secretofmonkeyisland	MonkeyIsland	The Secret of Monkey Island (Lucasfilm Games)
Seek&Destroy	SeekAndDestroy	Seek and Destroy (Vision/Mindscape)
SensibleGolf	SensibleGolf	Sensible Golf (Sensible Software)
SensibleSoccer	SensibleSoccer	Sensible Soccer (Sensible Software)
SensibleSoccerBulldogBlighty	SensibleSoccerBulldog	Sensible Soccer 92/93 Meets Bulldog Blighty (Sensible Software)
SensibleSoccerCD	SensibleSoccerCD	"Sensible Soccer CD&sup3;&sup2; (Sensible Software)"
SensibleSoccerEuropeanChampions	SensibleSoccer	Sensible Soccer (Sensible Software)
SensibleSoccerInternationalEdition	SensibleSoccer	Sensible Soccer (Sensible Software)
SensibleTrainSpotting	SensibleTrainSpotter	Sensible Train Spotter (Sensible Software)
SensibleWorldOfMoonSoccer	SensibleWorldMoonSoccer	Sensible World of Moon Soccer Demo (Sensible Software)
SensibleWorldOfSoccer	SWOS	Sensible World of Soccer (Sensible Software)
SensibleWorldOfSoccer11	SWOS	Sensible World of Soccer (Sensible Software)
SensibleWorldOfSoccer9596	SWOS	Sensible World of Soccer (Sensible Software)
SensibleWorldOfSoccer9596EuropeanChampions	SWOS	Sensible World of Soccer (Sensible Software)
SensibleWorldOfSoccer9697	SWOS	Sensible World of Soccer (Sensible Software)
Sentinel	Sentinel	Sentinel (Firebird)
Settlers	TheSettlers	The Settlers / Die Siedler (Blue Byte)
SevenCitiesOfGold	7CitiesOfGold	7 Cities Of Gold (Ozark Softscape/Electronic Arts)
SevenGatesOfJambala	SevenGatesOfJambala	Seven Gates of Jambala (Thalion)
Sextimates	Sextimates	Sextimates (Actionworks)
SeymourHollywood	SeymourHollywood	Seymour goes to Hollywood (Code Masters/Optimus Software)
ShadowDancer	ShadowDancer	Shadow Dancer (U.S.Gold)
ShadowFighter	ShadowFighter	Shadow Fighter (N.A.P.S Team/Gremlin)
ShadowFighterCD	ShadowFighterCD	"Shadow Fighter CD&sup3;&sup2; (Gremlin)"
ShadowLands	ShadowLands	Shadow Lands (Domark)
ShadowOfTheBeast	Beast	Shadow of the Beast (Psygnosis)
ShadowOfTheBeast2	Beast2	Shadow of the Beast 2 (Psygnosis)
ShadowOfTheBeast3	Beast3	Shadow of the Beast 3 (Psygnosis)
Shadoworlds	Shadoworlds	Shadoworlds (Krisalis)
ShadowSorcerer	ShadowSorcerer	Shadow Sorcerer (TSR/SSI/US Gold)
ShadowWarriors	ShadowWarriors	Shadow Warriors (Ocean)
Shanghai	Shanghai	Shanghai (Activision)
ShaqFu	Shaq-Fu	Shaq-Fu (Ocean/Dome Development)
SharkeysMoll	SharkeysMoll	Sharkeys Moll (Zeppelin Games)
SheFox	Vixen	Vixen / She-Fox (Martech Games)
ShermanM4	ShermanM4	Sherman-M4 (Loriciel)
Shinobi	Shinobi	Shinobi (Sega)
ShockWave	ShockWave	Shock Wave (Lightsource Productions/Digital Magic)
Shuffle	Shuffle	Shuffle (Tale Software)
ShufflepuckCafe	ShufflepuckCafe	"Shufflepuck Cafe (Br&oslash;derbund)"
Shuttle	Shuttle	Shuttle (Vektor Grafix/Virgin)
SideShow	SideShow	Side Show (Actionware)
SideWinder	SideWinder	Sidewinder (Arcadia Software)
SideWinder2	SideWinder2	Side Winder 2 (Pal developments/Virgin Mastertronics)
Siedler	Siedler	The Settlers / Die Siedler (Blue Byte)
SierraSoccer	SierraSoccer	Sierra Soccer (Dynamix)
SilentService	SilentService	Silent Service (Microprose)
SilentService2	SilentService2	Silent Service 2 (Microprose)
SiliconDreams	SiliconDreams	Silicon Dreams (Rainbird/Level 9)
Silkworm	Silkworm	Silkworm (Sales Curve)
SimLife	SimLife	Sim Life (Maxis)
SimonTheSorcerer	SimonTheSorcerer	Simon The Sorcerer (Adventure Soft)
Simulcra	Simulcra	Simulcra (Graftgold)
Sinbad	Sinbad	Sinbad and the Throne of the Falcon (Master Designer Software/Cinemaware)
SinkOrSwim	SinkOrSwim	Sink or Swim (Zeppelin Games/Odysseus Software)
SkaermtroldenHugo	SkaermtroldenHugo	"Sk&aelig;rmtrolden Hugo (SilverRock)"
SkeetShoot	SkeetShoot	Skeet Shoot (Trojan)
SkeletonKrew	SkeletonKrew	Skeleton Krew (Mindscape)
Skidmarks	Skidmarks	Skidmarks (Acid)
SkidMarks2	SkidMarks2	Super Skidmarks (Acid Software)
Skidz	Skidz	Skidz (Core Design/Gremlin)
SkiOrDie	SkiOrDie	Ski or Die (Electronic Arts)
Skrull	Skrull	Skrull (16-32Bit Diffusion)
Skull&Crossbones	SkullAndCrossbones	"Skull &amp; Cross Bones (Domark)"
Skweek	Skweek	Skweek (Loriciel)
SkyChase	SkyChase	Sky Chase (Imageworks)
Skyfox	Skyfox	Skyfox (Electronic Arts)
Skyfox2	Skyfox2	Skyfox II - The Cygnus Conflict (Dynamix/Electronic Arts)
SkyHighStuntman	SkyHighStuntman	Sky High Stuntman (Code Masters)
Slackskin&Flint	SlackskinAndFlint	"Slackskin &amp; Flint (Synergy/Fun Factory)"
SlamTilt	SlamTilt	Slam Tilt (Liquid Dezign/21st Century)
Slayer	Slayer	Slayer (Hewson)
SleepWalker	SleepWalker	Sleepwalker (Ocean)
Sliders	Sliders	"Sliders (Micro&iuml;ds/Palace)"
SlightlyMagic	SlightlyMagic	Slightly Magic (Code Masters)
SlipStream	SlipStream	Slip Stream (MicroDeal)
SlySpySecretAgent	SlySpySecretAgent	Sly Spy Secret Agent (Ocean)
SmashTV	SmashTV	Smash TV (Ocean)
Sneech	Sneech	Sneech (Paul Burkey)
Snoopy&Peanuts	SnoopyAndPeanuts	Snoopy And Peanuts (The Edge)
SnowBros	SnowBros	Snow Bros (Ocean)
SnowStrike	SnowStrike	Snow Strike (Epyx/US Gold)
SoccerKid	SoccerKid	Soccer Kid (Krisalis)
SoccerPinball	SoccerPinball	Soccer Pinball (Code Masters)
Soldier2000	Soldier2000	Soldier 2000 (Astronic)
SoldierOfLight	SoldierOfLight	Soldier of Light (Taito/ACE Developments)
SonicBoom	SonicBoom	Sonic Boom (Sega/Activision)
SonShuShi	SonShuShi	Son Shu-Shi (Expose Software)
SootyAndSweep	SootyAndSweep	"Sooty &amp; Sweep (Alternative Software)"
Sophelie	Sophelie	Sophelie (New Deal)
SorcererLord	SorcererLord	Sorcerer Lord (PSS)
SorcerorsApprentice	SorcerorsApprentice	Sorceror's Apprentice (Art Computer Software)
Sorcery	Sorcery	Sorcery+ (Virgin)
SoreFist	SoreFist	Sorefist (Snakesoft)
SpaceAce	SpaceAce	Space Ace (Ready Soft)
SpaceAce2	SpaceAce2	Space Ace 2 (Ready Soft)
SpaceBall	SpaceBall	Space Ball (Rainbow Arts)
SpaceCrusade	SpaceCrusade	Space Crusade (Gremlin)
SpaceCutter	SpaceCutter	Space Cutter (Maelstrom Games/Telecomsoft)
SpaceGun	SpaceGun	Space Gun (Ocean)
SpaceHarrier	SpaceHarrier	Space Harrier (Elite)
SpaceHarrier&ReturnToTheFantasyZone	SpaceHarrier&ReturnToTheFantasyZone	Space Harrier (Elite)
SpaceHarrier2	SpaceHarrier2	Space Harrier 2 (Sega)
SpaceHulk	SpaceHulk	Space Hulk (Electronic Arts)
SpaceMAX	SpaceMAX	Space MAX (Starbyte)
SpacePilot89	SpacePilot89	Space Pilot 89 (KingSoft)
SpaceQuest	SpaceQuest	Space Quest (Sierra)
SpaceQuest2	SpaceQuest2	Space Quest 2 (Sierra)
SpaceQuest3	SpaceQuest3	Space Quest 3 (Sierra)
SpaceQuest4	SpaceQuest4	Space Quest 4 (Sierra)
SpaceQuestEnhanced	SpaceQuestEnhanced	Space Quest Enhanced (Sierra)
SpaceRacer	SpaceRacer	Space Racer (Loriciels)
SpaceRogue	SpaceRogue	Space Rogue (Mindscape)
SpaceStation	SpaceStation	Space Station (Paradox)
SpecialForces	SpecialForces	Special Forces (Microprose)
Speedball	Speedball	Speedball (Bitmap Brothers)
SpeedBall2CD	SpeedBall2CD	"Speedball 2 CD&sup3;&sup2; (Renegade)"
SpeedboatAssassin	SpeedboatAssassin	Speedboat Assassin (Mastertronic)
SpeedBuggy	SpeedBuggy	Speed Buggy (Elite)
Spellbound	Spellbound	Spellbound (Psygnosis)
SpellfireTheSorceror	SpellfireTheSorceror	Spellfire the Sorceror (Code Masters)
SperisLegacy	SperisLegacy	The Speris Legacy (Team 17)
Spherical	Spherical	Spherical (Rainbow Arts)
SpikeInTransylvania	SpikeInTransylvania	Spike in Transylvania (Code Masters)
SpindizzyWorlds	SpindizzyWorlds	Spindizzy Worlds (Paul Shirley)
SpiritOfAdventure	SpiritOfAdventure	Spirit of Adventure (Starbyte)
SpittingImage	SpittingImage	Spitting Image (Domark)
Spot	Spot	Spot (Virgin/Mastertronic)
SpyVsSpy	SpyVsSpy	Spy Vs Spy (Wicked Software/First Star Software)
SpyVsSpy2TheIslandCaper	SpyVsSpy2IslandCaper	Spy Vs Spy 2: The Island Caper (Wicked Software/First Star Software)
SpyVsSpy3ArcticAntics	SpyVsSpy3ArcticAntics	Spy Vs Spy 3: Arctic Antics (Wicked Software/First Star Software)
SpyWhoLovedMe	SpyWhoLovedMe	The Spy Who Loved Me (Domark)
StackUp	StackUp	Stack Up (Zeppelin Games)
Starblade	Starblade	Starblade (Silmarils)
Starblaze	Starblaze	Starblaze (Logotron)
Stardust	Stardust	Stardust (Bloodhouse)
Starglider	Starglider	Starglider (Argonaut Software/Firebird)
Starglider2	Starglider2	Starglider 2 (Argonaut Software)
Stargoose	Stargoose	Stargoose (Logotron)
Starians	Starians	Starians (Amigo!)
Starray	Starray	Starray (Logotron)
StarTrash	StarTrash	Star Trash (Rainbow Arts)
StarTrek25th	StarTrek25th	Star Trek 25th Anniversary (Interplay)
Starush	Starush	Starush (Ubi Soft)
StarWars	StarWars	Star Wars (Lucasfilm Games/Domark)
Steel	Steel	Steel (Hewson)
SteelEmpire	SteelEmpire	Steel Empire (Silicon Knights)
StegTheSlug	StegTheSlug	Steg the Slug (Code Masters)
Steigar	Steigar	Steigar (Screen 7)
StoneAge	StoneAge	Stone Age (Eclipse)
Stormball	Stormball	Stormball (Millennium)
Stormlord	Stormlord	Stormlord (Hewson)
StormMaster	StormMaster	Storm Master (Silmarils)
Stratego	Stratego	Stratego (Accolade)
StreetFighter	StreetFighter	Streetfighter (Capcom)
Streetfighter2	Streetfighter2	Streetfighter 2 (Capcom/U.S.Gold)
StreetGang	StreetGang	Street Gang (Time Warp/Rainbow Arts)
StreetRacer	StreetRacer	Street Racer (Epic)
Strider	Strider	Strider (Tiertex/US Gold)
Strider2	Strider2	Strider 2 (U.S.Gold)
Striker	Striker	Striker (Rage Software)
StripPoker	StripPoker	Strip Poker (Artworx)
StripPoker2	StripPoker2	Strip Poker 2 / Deluxe Strip Poker (Artworx)
StripPoker2+	StripPoker2+	Strip Poker 2+ (Anco)
StripPoker3	StripPoker3	Strip Poker 3 (Artworx)
StripPot	StripPot	Strip Pot (Pixel-Blue)
Stryx	Stryx	Stryx (Psygnosis)
STUNRunner	STUNRunner	STUN Runner (Domark)
StuntCarRacer	StuntCarRacer	Stunt Car Racer (Microstyle)
StuntCarRacerTNT	StuntCarRacer	Stunt Car Racer (Microstyle)
StuntTrackRacer	StuntTrackRacer	Stunt Track Racer (Microplay)
Subbuteo	Subbuteo	Subbuteo (Goliath)
Subtrade	Subtrade	Subtrade (Boeder)
SuburbanCommando	SuburbanCommando	Suburban Commando (Alternative)
Subwar2050	Subwar2050	Subwar 2050 (Microprose)
SummerCamp	SummerCamp	Summer Camp (Thalamus)
SummerGames	SummerGames	Summer Games (U.S.Gold)
SummerOlympiad	SummerOlympiad	Summer Olympiad / Summer Challenge (TyneSoft/Thunder Mountain)
Supaplex	Supaplex	Supaplex (Digital Integration)
SuperC	SuperC	Super C (Konami/USI Unlimited Software Inc)
SuperCars	SuperCars	Super Cars (Gremlin)
SuperCars2	SuperCars2	Super Cars 2 (Gremlin)
SuperCauldron	SuperCauldron	Super Cauldron (Titus)
Superfrog	Superfrog	Superfrog (Team 17)
SuperfrogDemo	SuperfrogDemo	Superfrog Demo (Team 17)
SuperGrandPrix	SuperGrandPrix	Super Grand Prix (Codemasters)
SuperHangOn	SuperHangOn	"Super&middot;Hang&middot;On (Sega/Electric Dreams)"
SuperHeroDemo	SuperHeroDemo	Superhero Demo (Psygnosis/Kage)
SuperLoopz	SuperLoopz	Super Loopz (Audiogenic)
Superman	Superman	Superman: The Man Of Steel (TyneSoft/Subway/First star software)
SuperMethaneBros	SuperMethaneBros	Super Methane Bros (Apache)
SuperMonacoGP	SuperMonacoGP	Super Monaco GP (U.S.Gold)
SuperObliteration	SuperObliteration	Super Obliteration (David Papworth)
SuperOffroad	SuperOffroad	Super Offroad (Graftgold)
SuperOsWald	SuperOsWald	Super OsWALD (SilverRock)
SuperScrambleSimulator	SuperScrambleSimulator	Super Scramble Simulator (Gremlin/Magnetic Fields)
SuperSeymour	SuperSeymour	Super Seymour saves the Planet (Code Masters/Optimus Software)
SuperSki	SuperSki	"Super Ski / Eddie Edwards Super Ski / Downhill Challenge (Micro&iuml;ds/Loriciel/Br&oslash;derbund)"
SuperSki2	SuperSki2	"Super Ski 2 (Micro&iuml;ds)"
SuperSpaceInvaders	SuperSpaceInvaders	Super Space Invaders (Taito/Domark)
SuperStarDust	SuperStarDust	Super Stardust (Bloodhouse)
SuperStreetFighter2	SuperStreetFighter2	Super Street Fighter 2 (US Gold)
SuperStreetFighter2Turbo	SuperStreetFighter2Turbo	Super Street Fighter 2 Turbo (Gametek)
SuperTennisChamps	SuperTennisChamps	Super Tennis Champs (Audiogenic)
SuperTetris	SuperTetris	Super Tetris (Spectrum Holobyte)
Supremacy	Supremacy	Supremacy (Virgin Mastertronic)
SurfNinjas	SurfNinjas	Surf Ninjas (Creative Edge)
SuspiciousCargo	SuspiciousCargo	Suspicious Cargo (Gremlin)
Swap	Swap	"Swap (Micro&iuml;ds/Palace)"
Switchblade	Switchblade	Switchblade (Core Design/Gremlin)
Switchblade2	Switchblade2	Switchblade 2 (Gremlin)
SWIV	SWIV	SWIV (Sales Curve)
Swooper	Swooper	Swooper (Diamond)
Sword	Sword	Sword (Serio-Comic)
Sword&TheRose	TheSwordAndTheRose	The Sword and the Rose (Code Masters)
SwordOfHonour	SwordOfHonour	Sword of Honour (Prestige)
SwordOfSodan	SwordOfSodan	Sword of Sodan (Discovery Software)
SWOS	SWOS	Sensible World of Soccer (Sensible Software)
Syndicate	Syndicate	Syndicate (Bullfrog)
TableTennisSimulation	TableTennisSimulation	Table Tennis Simulation (Starbyte)
Taekwondo	Taekwondo	Taekwondo (Anco)
Tangram	Tangram	Tangram (Thalion)
Targhan	Targhan	Targhan (Silmarils)
T-Bird	T-Bird	T-Bird (PAL Developments)
TeamSuzuki	TeamSuzuki	Team Suzuki (Gremlin)
TearawayThomas	TearawayThomas	Tearaway Thomas (Head-On Technology)
Tech	Tech	Tech (Gainstar/The Omega Team)
Technocop	Technocop	Technocop (Imagexcel)
Technology2	Technology2	Technology 2 (Mental Image)
TeenageMutantHeroTurtles	TeenageMutantHeroTurtles	Teenage Mutant Hero Turtles (Mirrorsoft/Probe)
TeenageMutantHeroTurtlesCoinOp	TeenageMutantArcade	Teenage Mutant Hero Turtles (Arcade) (Konami)
TeenageMutantNinjaTurtles	TeenageMutantNinja	Teenage Mutant Ninja Turtles (Ultra Games)
TeenageQueen	TeenageQueen	Teenage Queen (Ere)
Teller	TheTeller	The Teller / The Brain Blasters (UBI-Soft)
TennisChamps	TennisChamps	Tennis Champs (Mental Software)
TennisCup	TennisCup	Tennis Cup (Loriciel/Electronic Zoo)
TennisCup2	TennisCup2	Tennis Cup 2 (Loriciel)
TensaiDemo	TensaiDemo	Tensai Demo (Synergy/Grandslam)
Terminator2ArcadeGame	Terminator2-Arcade	Terminator 2 - Arcade Game (Virgin)
Terminator2JudgmentDay	Terminator2JD	Terminator 2 - Judgment Day (Carolco/Ocean)
TerrysBigAdventure	TerrysBigAdventure	Terry's Big Adventure (Grandslam)
TestDrive	TestDrive	Test Drive (Accolade)
TestDrive2	TestDrive2	Test Drive 2 - The Duel (Accolade)
TetraQuest	TetraQuest	Tetra Quest (Microdeal)
Tetris	Tetris	Tetris (MirrorSoft)
TetrisSC	TetrisSC	Tetris: The Soviet Challenge (Spectrum HoloByte)
Tetrix	Tetrix	Tetrix (Markus Olinger/CT-Verlag)
TheatreOfDeath	TheatreOfDeath	Theatre of Death (Psygnosis/Shed Software)
TheBallGame	TheBallGame	The Ball Game (Electronic Zoo)
TheChamp	TheChamp	The Champ (Linel)
TheCycles	TheCycles	The Cycles (Accolade)
TheEnforcer	TheEnforcer	The Enforcer (Trojan)
TheFlintstones	TheFlintstones	The Flintstones (Grandslam/Teque)
ThemePark	ThemePark	Theme Park (Bullfrog)
ThemeParkMystery	ThemeParkMystery	Theme Park Mystery (Imageworks/Konami)
TheMunsters	TheMunsters	The Munsters (Tiger Developments/Teque)
ThePawn	ThePawn	The Pawn (Magnetic Scrolls)
TheRaiders	TheRaiders	The Raiders (Silmarils)
TheShortGrey	TheShortGrey	The Short Grey (Accrosoft)
TheThreeStooges	TheThreeStooges	The Three Stooges (Cinemaware)
TheWall	TheWall	The Wall (Rainbow Arts)
Thexder	Thexder	Thexder (Sierra)
ThirdReich	ThirdReich	Third Reich (Avalon Hill)
ThomasTankEngine	ThomasTankEngine	Thomas the Tank Engine (Britt Allcroft)
ThomasTheTankEngine2	ThomasTankEngine2	Thomas the Tank Engine 2 (Britt Allcroft)
ThomasTheTankEnginePinball	ThomasTankEnginePinball	Thomas the Tank Engine Pinball (Spidersoft)
Thunderbirds	Thunderbirds	Thunderbirds (Grandslam)
ThunderBlade	ThunderBlade	Thunder Blade (Sega)
ThunderBoy	ThunderBoy	Thunder Boy (Time Warp Production/Rainbow Arts)
ThunderBurner	ThunderBurner	Thunder Burner (Loriciel)
ThunderCats	ThunderCats	Thunder Cats (Elite)
ThunderHawkAH73M	Thunderhawk	Thunderhawk (Core Design)
ThunderJaws	ThunderJaws	Thunder Jaws (Tengen/Domark)
Thunderstrike	Thunderstrike	Thunderstrike (Millennium)
TieBreak	TieBreak	Tie-Break (Starbyte)
TigerRoad	TigerRoad	Tiger Road (Capcom)
Time	Time	Time (Empire)
TimeBandit	TimeBandit	Time Bandit (Microdeal)
TimeLock	TimeLock	Time Lock (Boeder Software)
TimeMachine	TimeMachine	Time Machine (Vivid Image)
TimeRace	TimeRace	Time Race (Loriciel)
TimeRunners	TimeRunners	Time Runners (Simulmondo)
TimeRunners01	TimeRunners01	Time Runners 01: Gateways In Time (Simulmondo)
TimeRunners02	TimeRunners02	Time Runners 02: The Space Stone (Simulmondo)
TimeRunners03	TimeRunners03	Time Runners 03: The Big Run (Simulmondo)
TimeRunners04	TimeRunners04	Time Runners 04: The Castle Of Fear (Simulmondo)
TimeRunners05	TimeRunners05	Time Runners 05: The Black Knight (Simulmondo)
TimeRunners06	TimeRunners06	Time Runners 06: The Bewitched Forest (Simulmondo)
TimeRunners07	TimeRunners07	Time Runners 07: The Land Of The Invaders (Simulmondo)
TimeRunners08	TimeRunners08	Time Runners 08: The Impregnable Fortress (Simulmondo)
TimeRunners09	TimeRunners09	Time Runners 09: The Time Demon (Simulmondo)
TimeRunners10	TimeRunners10	Time Runners 10: The Time Sentry (Simulmondo)
TimeRunners11	TimeRunners11	Time Runners 11: The Steel City (Simulmondo)
TimeRunners12	TimeRunners12	Time Runners 12: A Target For The Cyborg (Simulmondo)
TimeRunners13	TimeRunners13	Time Runners 13: Cyberkiller (Simulmondo)
TimeRunners14	TimeRunners14	Time Runners 14: Toraxid - War Star (Simulmondo)
TimeRunners15	TimeRunners15	Time Runners 15: At The Speed Of Light (Simulmondo)
TimeRunners16	TimeRunners16	Time Runners 16: The Galaxy Emperor (Simulmondo)
TimeRunners17	TimeRunners17	Time Runners 17: The Living Labyrinth (Simulmondo)
TimeRunners18	TimeRunners18	Time Runners 18: The Killer Shadow (Simulmondo)
TimeRunners19	TimeRunners19	Time Runners 19: The Nightmare Prince (Simulmondo)
TimeRunners20	TimeRunners20	Time Runners 20: The Mountains Of Death (Simulmondo)
TimeRunners21	TimeRunners21	Time Runners 21: The Black Dragon's Course (Simulmondo)
TimeRunners22	TimeRunners22	Time Runners 22: The Eternal Damned (Simulmondo)
TimeRunners23	TimeRunners23	Time Runners 23: The Time Monarch (Simulmondo)
TimeRunners24	TimeRunners24	Time Runners 24: Beyond all Dimensions (Simulmondo)
TimeRunners25	TimeRunners25	Time Runners 25: The lost Planet Earth (Simulmondo)
TimeRunners26	TimeRunners26	Time Runners 26: The Time Warrior (Simulmondo)
TimeRunners27	TimeRunners27	Time Runners 27: Red Night (Simulmondo)
TimeRunners28	TimeRunners28	Time Runners 28: Beyond The End (Simulmondo)
TimeRunners29	TimeRunners29	Time Runners 29: The Last Revelation (Simulmondo)
TimeRunners30	TimeRunners30	Time Runners 30: The Final Duel (Simulmondo)
TimeScanner	TimeScanner	Time Scanner (Activision)
TimesOfLore	TimesOfLore	Times of Lore (Origin)
TimeSoldiers	TimeSoldiers	Time Soldiers (Smart Egg Software)
TintinOnTheMoon	TintinOnTheMoon	Tintin on the Moon / Tim und Struppi auf dem Mond (Infogrames)
TinToyAdventure	TinToyAdventure	Tin Toy Adventure (Mutation Software)
TinySkweeks	TinySkweeks	Tiny Skweeks (Loriciel)
TinyTroops	TinyTroops	Tiny Troops (Vulcan)
TipOff	TipOff	Tip Off (ANCO)
Titan	Titan	Titan (Titus)
TitanicBlinky	TitanicBlinky	Titanic Blinky (Zeppelin Games)
TitusTheFox	Moktar	Moktar / Titus the Fox (Titus)
Toki	Toki	Toki (Ocean)
TomAndTheGhost	TomAndTheGhost	Tom and the Ghost (Blue Byte/Ubi Soft)
TommyGun	TommyGun	Tommy Gun (Mutation Software)
Toobin	Toobin	Toobin (Domark)
TopBanana	TopBanana	Top Banana (Hex)
TopCat	TopCat	Top Cat (Hi-Tec)
TopGear2	TopGear2	Top Gear 2 (Gremlin Interactive)
TopSecret	TopSecret	Top Secret (The Hidden)
Tornado	Tornado	Tornado (Digital Integration)
TornadoGroundAttack	TornadoGroundAttack	Tornado Ground Attack (Energize)
TorvakTheWarrior	TorvakTheWarrior	Torvak the Warrior (Core Design)
TotalCarnage	TotalCarnage	Total Carnage (ICE)
TotalEclipse	TotalEclipse	Total Eclipse (Incentive Software/Domark)
TotalFootball	TotalFootball	Total Football (Domark/Acclaim)
TotalRecall	TotalRecall	Total Recall (Ocean)
TowerOfBabel	TowerOfBabel	Tower of Babel (Rainbird)
TowerOfSouls	TowerOfSouls	Tower Of Souls / Der Seelenturm (Black Legend)
TowerToppler	TowerToppler	Tower Toppler (Hewson)
ToyotaCelicaGTRally	ToyotaCelicaGTRally	Toyota Celica GT Rally (Gremlin)
TRacer	TRacer	T-Racer (Virtual Dreams)
Tracker	Tracker	Tracker (Mindware/Rainbird)
Traders	Traders	Traders (Linel)
TrainedAssassin	TrainedAssassin	Trained Assassin (Digital Magic Software)
Transarctica	Transarctica	Transarctica (Silmarils)
Transplant	Transplant	Transplant ()
TrapsNTreasures	TrapsNTreasures	Traps'n'Treasures (Starbyte)
TreasureIslandDizzy	TreasureIslandDizzy	Treasure Island Dizzy (Code Masters)
TrexWarrior	TrexWarrior	Trex Warrior (Thalion)
TrivialPursuit	TrivialPursuit	Trivial Pursuit (Domark)
TrivialPursuit2	TrivialPursuit2	Trivial Pursuit Genus 2 ()
Troddlers	Troddlers	Troddlers (Sales Curve)
Trolls	Trolls	Trolls (Flair Software)
TubeWarriors	TubeWarriors	Tube Warriors (Dynabyte)
Turbo	Turbo	Turbo (Microillusions)
TurboOutrun	TurboOutrun	Turbo Outrun (U.S.Gold)
TurboTrax	TurboTrax_Arcane	Turbo Trax (Arcane) (Arcane)
TurnNBurn	TurnNBurn	Turn'n'Burn (Flair)
Turrican	Turrican	Turrican (Factor 5/Rainbow Arts)
Turrican2	Turrican2	Turrican 2 (Factor 5/Rainbow Arts)
Turrican2Demo	Turrican2Demo	Turrican 2 Demo (Rainbow Arts)
Turrican3	Turrican3	Turrican 3 (Factor 5/Rainbow Arts)
Turrican3Demo	Turrican3Demo	Turrican 3 Demo (Factor 5)
Tusker	Tusker	Tusker (System 3)
Twintris	Twintris	Twintris (Digital Marketing)
TwinWorld	TwinWorld	Twin World (Blue Byte/UBI-Soft)
Twylyte	Twylyte	Twylyte (Wicked)
Typhoon	Typhoon	Typhoon (Kingsoft)
TyphoonThompson	TyphoonThompson	Typhoon Thompson (Br°derbund)
UFOEnemyUnknown	UFO	UFO - Enemy Unknown (Microprose)
Ugh	Ugh	Ugh! (PlayByte/Ego Software)
UltimateBodyBlows	UltimateBodyBlows	Ultimate Body Blows (Team 17)
UltimateGolf	UltimateGolf	Ultimate Golf (Gremlin)
UltimaV	UltimaV	Ultima V (Origin)
UnderPressure	UnderPressure	Under Pressure (Electronic Zoo)
UniversalMilitarySimulator	UMS	UMS: Universal Military Simulator (Firebird)
UniversalWarrior	UniversalWarrior	Universal Warrior (Zeppelin Games)
Universe	Universe	Universe (Core Design)
Unreal	Unreal	Unreal (Ordilogic Systems/UBI-Soft)
UnsensibleSoccer	UnsensibleSoccer	Unsensible Soccer (Sensible Software)
UNSquadron	UNSquadron	UN Squadron (U.S.Gold)
Untouchables	Untouchables	Untouchables (Ocean)
Uridium2	Uridium2	Uridium 2 (Graftgold)
Utopia	Utopia	Utopia (Gremlin)
Utopia&NewWorlds	Utopia	Utopia (Gremlin)
Vader	Vader	Vader (Softgang)
ValhallaBeforeTheWar	ValhallaBTW	Valhalla - Before The War (Vulcan)
ValhallaLordOfInfinity	ValhallaLOI	Valhalla & the Lord of Infinity (Vulcan)
VampiresEmpire	VampiresEmpire	Vampires Empire (DigiTek Software)
Vaxine	Vaxine	Vaxine (Assembly Line/U.S.Gold)
Vectorball	Vectorball	Vectorball (Mastertronic)
VegasGambler	VegasGambler	Vegas Gambler (California Dreams)
VenomWing	VenomWing	Venom Wing (Thalamus/SoftEyes)
VenusTheFlytrap	VenusTheFlytrap	Venus the Flytrap (Gremlin)
VictoryRoad	VictoryRoad	Victory Road (SNK/Imagine)
VideoKid	VideoKid	Video Kid (Gremlin)
Vigilante	Vigilante	Vigilante (U.S.Gold/Emerald Software)
Vindicators	Vindicators	Vindicators (Tengen/Domark)
Violator	Violator	Violator (Code Masters)
Virocop	Virocop	Virocop (Graftgold)
VirtualKarting2	VirtualKarting2	Virtual Karting 2 (Islona)
Virus	Virus	Virus (D.J. Braben)
VitalLight	VitalLight	Vital Light (Millennium/Effective Chaos)
Vixen	Vixen	Vixen / She-Fox (Martech Games)
Viz	Viz	Viz (Virgin)
Volfied	Volfied	Volfied (Empire)
VoodooNightmare	VoodooNightmare	Voodoo Nightmare (Palace Software)
Voyager	Voyager	Voyager (Ocean)
VoyageursDuTemps	FutureWars	Future Wars / Les Voyageurs Du Temps (Delphine Software)
Vroom	Vroom	Vroom (Lankhor)
Vroom&DataDisk	Vroom	Vroom (Lankhor)
VroomMultiplayer	VroomMultiplayer	Vroom Multiplayer (Lankhor)
Vyrus	Vyrus	Vyrus (Amiga Fun)
WackyDarts	WackyDarts	Wacky Darts (Code Masters)
WackyRaces	WackyRaces	Wacky Races (PAL Developments/Hi-Tec)
WacusTheDetective	WacusTheDetective	Wacus The Detective (LK Avalon/Lazy Artists)
Walker	Walker	Walker (DMA Design/Psygnosis)
Wanted	Wanted	Wanted (Infogrames)
Warhead	Warhead	Warhead (Glyn Williams)
WarInMiddleEarth	WarInMiddleEarth	War In Middle Earth (Melbourne House/Synergistic)
WarlockTheAvenger	WarlockTheAvenger	Warlock the Avenger (Millenium)
WarMachine	WarMachine	War Machine (Players Premier)
WarmUp	WarmUp	Warm Up (GENIAS)
WARP	WARP	WARP (Thalion)
Warzone	Warzone	Warzone (Core Design)
Warzone_Paradox	Warzone_Paradox	Warzone (Paradox Software)
WatchTower	WatchTower	WatchTower (OTM/Cyberarts)
Waterloo	Waterloo	Waterloo (PSS/MirrorSoft)
Waxworks	Waxworks	Waxworks (Accolade)
WayneGretzkyHockey	WayneGretzkyHockey	Wayne Gretzky Hockey (Betchesda SoftWorks)
WayneGretzkyHockey2	WayneGretzkyHockey2	Wayne Gretzky Hockey 2 (Bechesda SoftWorks)
WayOfTheLittleDragon	WayOfTheLittleDragon	The way of the Little Dragon (Parsec Software)
WCLeaderboardGolf	WCLeaderboardGolf	World Class Leaderboard Golf (Access)
Ween	Ween	Ween: The Prophecy (Coktel Vision)
WeirdDreams	WeirdDreams	Weird Dreams (Rainbird)
Welltris	Welltris	Welltris (Spectrum Holobyte)
WembleyRugbyLeague	WembleyRugbyLeague	Wembley Rugby League (Audiogenic)
WestPhaser	WestPhaser	West Phaser (Loriciel)
Whirligig	Whirligig	Whirligig (Firebird)
Whizz	Whizz	Whizz (Flair Software)
WhoFramedRogerRabbit	WhoFramedRogerRabbit	Who Framed Roger Rabbit? (Buena Vista Software)
Wicked	Wicked	Wicked (Electric Dreams/Binary Vision)
WildCupSoccer	WildCupSoccer	Wild Cup Soccer (Teque/Millennium)
WildStreets	WildStreets	Wild Streets (Titus)
WildWestWorld	WildWestWorld	Wild West World (Software 2000)
WildWheels	WildWheels	Wild Wheels (Red Rat Software/Ocean)
WindowWizard	WindowWizard	Window Wizard (reLINE)
WindSurfWilly	WindSurfWilly	Wind Surf Willy (Silmarils)
Wings	Wings	Wings (Cinemaware)
WingsOfDeath	WingsOfDeath	Wings of Death (Thalion/Eclipse)
WingsOfFury	WingsOfFury	"Wings of Fury (Br&oslash;derbund)"
WinningPost	WinningPost	Winning Post (Mental Image)
WinterCamp	WinterCamp	Winter Camp (Thalamus)
WinterOlympiad	WinterOlympiad	Winter Olympiad / Winter Challenge (Tynesoft/Thunder Mountain)
WinterOlympics	WinterOlympics	Winter Olympics (U.S.Gold)
WinterSuperSports92	WinterSuperSports92	Winter Super Sports '92 (Flair Software)
Wizball	Wizball	Wizball (Ocean)
Wizkid	Wizkid	Wizkid (Sensible Software)
WizNLiz	WizNLiz	Wiz'n'Liz (Psygnosis)
Wolfchild	Wolfchild	Wolfchild (Core Design)
Wolfpack	Wolfpack	Wolfpack (Novalogic/Mirrorsoft)
WonderboyInMonsterland	WonderboyInMonsterland	Wonderboy in Monsterland (Activision/Sega)
WonderDog	WonderDog	Wonderdog (Core Design)
WoodysWorld	WoodysWorld	Woody's World (Vision)
WorldChampBoxingManager	WorldChampBoxingManager	World Championship Boxing Manager (Goliath Games)
WorldChampSoccer	WorldChampSoccer	World Championship Soccer (Elite)
WorldCircuit	WorldCircuit	World Circuit (Geoff Crammond/Microprose)
WorldClassRugby	WorldClassRugby	World Class Rugby (Audiogenic)
WorldClassRugby5Nations	WorldClassRugby5Nations	World Class Rugby - 5 Nations Edition (Audiogenic)
WorldClassRugby95	WorldClassRugby95	World Class Rugby '95 (Audiogenic)
WorldClassSoccer	WorldClassSoccer	World Class Soccer (U.S.Gold)
WorldCricket	WorldCricket	World Cricket (Zeppelin Games)
WorldGames	WorldGames	World Games (Epyx/Westwood Associates)
WorldRugby	WorldRugby	World Rugby (Zeppelin)
WorldSoccer	WorldSoccer	World Soccer (Zeppelin Games)
WorldsOfLegend	WorldsOfLegend	Worlds of Legend (Mindscape)
Worms	Worms	Worms (Team 17)
WormsDirectorsCut	WormsDC	Worms - The Director's Cut (Team 17)
WormSigns	WormSigns	Worm Signs (Proxima)
WrathOfTheDemon	WrathOfTheDemon	Wrath of the Demon (Ready Soft)
Wreckers	Wreckers	Wreckers (Audiogenic)
WWFEuropeanRampage	WWFEuropeanRampage	WWF European Rampage (Ocean)
WWFWrestlemania	WWFWrestlemania	WWF Wrestlemania (Ocean)
Xenex	Xenex	Xenex (Scorpius Software)
Xenomorph	Xenomorph	Xenomorph (Pandora)
Xenon	Xenon	Xenon (Bitmap Brothers)
Xenon2	Xenon2	Xenon 2 (Bitmap Brothers)
Xenon2Demo	Xenon2Demo	Xenon 2 Demo (Bitmap Brothers)
Xenophobe	Xenophobe	Xenophobe (Microstyle)
Xiphos	Xiphos	Xiphos - The universe unfolds (Electronic Zoo)
XIt	X-It	X-It (Psygnosis)
XOut	X-Out	X-Out (Rainbow Arts)
XP8	XP8	XP8 (Weathermine Software)
XR35	XR35	XR-35 (Anco)
Xybots	Xybots	Xybots (Tengen)
YogiBear&Friends	YogiBearAndFriends	Yogi Bear and Friends in The Greed Monster (Hi-Tec)
YogisGreatEscape	YogisGreatEscape	Yogi's Great Escape (Hi-Tec)
YoJoe	YoJoe	Yo! Joe! (Scipio/Play Byte/Hudson Soft)
YoJoeDemo	YoJoeDemo	Yo! Joe! Demo (Scipio/Play Byte/Hudson Soft)
Yolanda	Yolanda	Yolanda (Vectordean)
ZakMcKracken	ZakMcKracken	Zak Mc Kracken (Lucasfilm Games)
ZanyGolf	ZanyGolf	Zany Golf (Electronic Arts)
Zarathrusta	Zarathrusta	Zarathrusta (Hewson)
Zaxxon	Zaxxon	Zaxxon (Bignonia)
Zeewolf	Zeewolf	Zeewolf (Binary Asylum)
Zeewolf2	Zeewolf2	Zeewolf 2 (Binary Asylum)
ZeroGravity	ZeroGravity	Zero Gravity (EAS)
Ziriax	Ziriax	Ziriax (The Whiz Kids)
Zombi	Zombi	Zombi (UBI-Soft)
ZombieApocalypse	ZombieApocalypse	Zombie Apocalypse (Vision Software)
ZombieApocalypse2	ZombieApocalypse2	Zombie Apocalypse 2 (Vision Software)
ZoneWarrior	ZoneWarrior	Zone Warrior (Electronic Arts)
Zool	Zool	Zool (Gremlin)
Zool2	Zool2	Zool 2 (Gremlin)
Zoom	Zoom	Zoom! (Discovery Software)
ZOut	Z-Out	Z-Out (Advantec/Rainbow Arts)
Zyconix	Zyconix	Zyconix (Accolade)
Zynaps	Zynaps	Zynaps (Hewson)
Aaargh	Aaargh	Aaargh! (Arcadia Systems)
